word	group_known
años	False
vida	True
país	False
año	True
mundo	False
presidente	False
caso	False
forma	True
millones	False
hombre	False
nacional	False
política	False
partido	True
grupo	True
frente	False
personas	False
mujer	True
ciudad	True
social	False
sistema	True
historia	True
punto	True
noche	True
situación	True
tipo	True
agua	True
países	False
ley	True
proceso	True
mano	True
cambio	True
importante	True
realidad	True
desarrollo	True
sociedad	True
centro	True
número	True
cuerpo	True
gente	True
siglo	True
guerra	True
obra	True
padre	False
ojos	True
don	False
pueblo	False
muerte	True
público	False
problemas	False
mañana	True
madre	False
nombre	True
meses	False
hombres	True
derecho	False
problema	False
cabeza	False
hora	False
ministro	False
información	True
señor	False
mujeres	True
tierra	False
director	True
pesetas	False
manos	True
llegar	False
cosa	False
familia	True
equipo	True
casos	True
falta	True
seguridad	True
nivel	False
voz	False
iba	False
semana	False
mayoría	False
español	True
luz	True
orden	True
político	True
proyecto	True
mercado	True
internacional	False
paso	False
empresa	True
policía	False
palabras	False
fuerza	True
puesto	False
puerta	False
comisión	False
programa	False
española	False
real	True
único	True
acción	False
libro	False
interior	True
condiciones	True
calle	False
obras	False
capital	False
música	True
dios	False
fondo	True
persona	False
dinero	True
hijo	True
zona	False
tema	True
razón	True
camino	True
papel	True
vista	True
hablar	False
presencia	True
libertad	True
especial	False
actual	True
relaciones	False
servicio	True
campo	True
relación	True
minutos	False
medios	False
producción	True
movimiento	True
idea	True
julio	True
miembros	True
interés	True
alto	True
principio	False
dirección	False
arte	True
cultura	True
empresas	True
hacía	False
visto	False
puntos	False
mes	False
sector	True
población	True
difícil	True
fuerzas	True
grupos	False
imagen	True
figura	True
futuro	True
militar	True
servicios	True
espacio	True
posibilidad	False
niños	True
económica	True
economía	True
personal	True
jefe	True
carácter	False
organización	True
central	True
actividad	True
aire	True
banco	False
prensa	False
popular	True
necesario	False
justicia	True
joven	False
comunidad	True
edad	False
políticos	True
efecto	False
pública	False
cara	True
crisis	True
decisión	False
necesidad	True
duda	True
capacidad	True
estudio	False
dólares	False
ministerio	False
defensa	True
mundial	False
televisión	False
serie	True
quiero	False
sociales	False
datos	True
base	True
investigación	True
época	False
control	True
queda	False
hijos	True
pasar	False
civil	False
salud	True
paz	True
juego	True
presente	False
niño	False
resultados	True
educación	True
derechos	True
resultado	True
conjunto	True
recursos	False
atención	True
allá	False
izquierda	False
partidos	False
importancia	True
contrario	True
menor	False
pasa	False
resto	True
gracias	True
administración	True
palabra	True
seguir	True
salir	True
fuerte	True
causa	True
calidad	False
medida	False
elecciones	True
secretario	True
silencio	True
comunicación	True
libre	True
fuentes	True
parecía	False
oficial	False
cine	True
mesa	True
cabo	False
españoles	False
naturaleza	False
apoyo	True
importantes	False
común	True
económico	False
principal	True
sol	False
decía	False
energía	False
mar	True
clase	False
dejar	False
especialmente	False
experiencia	True
cantidad	True
jóvenes	False
objeto	False
rey	True
opinión	False
función	False
estudios	True
superior	True
posición	True
única	False
reunión	False
color	True
respuesta	True
trabajadores	False
radio	True
viejo	True
alta	False
sangre	False
evitar	False
elementos	True
resulta	False
partes	False
pensar	False
suelo	True
lucha	True
actividades	False
origen	True
ejército	True
boca	False
medidas	True
cargo	True
américa	False
tomar	False
autoridades	False
autor	True
hechos	True
precisamente	False
pie	True
existencia	True
ayuda	True
productos	True
régimen	False
objetivo	True
teatro	True
políticas	False
sabía	False
línea	True
quería	False
crecimiento	False
acciones	True
encuentro	True
muestra	False
natural	True
compañía	False
derecha	False
carta	False
seguro	True
momentos	False
amigos	False
artículo	True
acto	False
doctor	True
amigo	False
viene	False
formas	False
consecuencia	False
región	True
cuarto	False
ve	False
campaña	True
diario	True
norte	False
metros	False
argentina	False
deja	False
éxito	False
ambiente	False
tiempos	False
actitud	False
escuela	True
especie	False
participación	True
domingo	False
formación	False
finalmente	False
permite	True
blanco	True
marcha	True
baja	False
río	True
principales	False
espera	False
mitad	True
juez	False
sur	True
entrada	True
grande	False
cuadro	True
vivir	False
miedo	True
cambios	True
enfermedad	True
valores	True
llegado	False
mayo	True
estructura	True
negro	True
acerca	False
mira	False
ideas	True
expresión	False
santa	True
construcción	True
análisis	False
peso	True
padres	False
fácil	False
conocimiento	True
pequeño	True
tratamiento	True
democracia	True
materia	False
humanos	True
corazón	False
fecha	False
mayores	False
cuestión	False
unidad	False
diferencia	False
plazo	False
vino	True
período	True
llega	False
texto	True
efectos	False
señora	False
práctica	False
volvió	False
informe	False
puerto	True
cultural	False
socialista	False
oposición	True
carrera	False
tribunal	False
industria	True
pese	False
médico	True
volver	False
asunto	False
mirada	True
exterior	True
llamado	False
favor	False
produce	False
libros	False
enero	True
conciencia	True
atrás	False
mantener	False
cámara	True
modelo	True
electoral	False
sectores	False
diciembre	False
fuego	False
distintos	False
intereses	True
salida	True
técnica	True
ocasión	False
fiscal	True
mejores	False
comercio	True
creación	True
solución	False
vuelta	False
entrar	True
suerte	False
razones	True
aumento	True
pasó	False
principios	True
militares	False
sala	True
humano	True
ocasiones	False
revolución	True
reforma	False
precio	True
características	False
voluntad	False
aspectos	False
recuerdo	False
puso	False
capaz	False
juicio	True
encontrar	False
película	True
programas	False
zonas	True
hija	False
asimismo	False
memoria	True
prueba	True
primeras	True
junio	True
sueño	True
contenido	False
operación	False
título	False
octubre	True
cama	True
toma	False
fútbol	True
posibilidades	False
esfuerzo	False
asociación	False
temas	False
particular	True
producto	True
aspecto	False
vio	False
muerto	False
marco	False
local	True
etapa	False
pequeña	False
corte	False
profesional	False
violencia	False
armas	False
dolor	True
pone	False
ciencia	False
precios	False
presenta	False
llama	False
centros	False
pregunta	True
generales	False
jamás	False
visita	False
victoria	False
suficiente	False
semanas	False
vía	False
riesgo	True
propuesta	True
vuelve	False
busca	False
consumo	False
aparece	False
área	False
siguientes	False
grado	False
tipos	False
encuentran	False
estilo	False
concepto	False
instituciones	False
cielo	False
carne	True
instituto	True
larga	True
material	True
perdido	False
comenzó	False
deseo	True
hermano	True
lenguaje	False
dije	False
cree	False
líder	True
oro	True
humana	False
abril	True
términos	False
buscar	True
simple	True
podido	False
imposible	True
marzo	False
ido	False
conocido	False
septiembre	True
rostro	False
anteriores	False
curso	True
destino	True
nacionales	False
nación	False
motivo	False
piel	True
departamento	False
grave	True
francés	True
condición	True
asuntos	False
preguntó	False
trabajos	False
tercer	False
terreno	False
obtener	True
club	True
responsabilidad	True
hospital	False
ejecutivo	False
comité	False
capítulo	True
noviembre	False
palacio	True
escrito	True
daba	False
doña	False
digo	False
movimientos	True
término	True
máximo	True
propiedad	True
lengua	True
niveles	True
industrial	True
organismo	True
doble	True
ocurre	False
proyectos	False
distancia	True
contacto	False
ejercicio	False
peligro	False
calles	True
oportunidad	False
leyes	True
novela	True
significa	False
ciudades	False
funciones	False
animales	False
presión	True
altura	False
gusta	False
selección	True
gusto	False
teoría	True
isla	True
espíritu	False
lunes	True
pensamiento	True
alma	False
imágenes	False
aplicación	True
verano	True
esperar	False
paciente	True
agosto	True
lograr	True
dejado	False
guardia	True
exposición	True
lugares	True
hotel	True
par	True
crear	True
lista	True
factores	True
sistemas	True
pueblos	False
tratado	False
ciudadanos	True
declaraciones	False
sitio	False
realmente	False
pies	False
dirigentes	False
demanda	True
directamente	False
maestro	False
viernes	False
clara	False
confianza	True
brazos	False
funcionarios	False
sale	False
llamada	True
marido	False
frecuencia	True
moral	True
pequeños	False
diputados	False
totalmente	False
visión	True
intervención	False
normal	True
pobre	True
supone	False
municipal	True
finales	True
kilómetros	False
jugadores	True
objetivos	True
perder	True
esposa	False
fuente	True
enorme	True
discurso	True
pena	False
judicial	True
acceso	True
necesidades	True
protección	True
procesos	False
circunstancias	True
entender	True
conflicto	True
pesos	False
presidencia	False
febrero	True
oficiales	False
páginas	False
representantes	False
temporada	False
públicas	False
pacientes	True
flores	False
evolución	True
técnico	False
pan	True
mala	False
salió	False
red	False
fundamental	False
superficie	True
escena	True
golpe	True
profesionales	False
alcalde	False
teléfono	True
café	True
propósito	True
candidato	True
gesto	True
líneas	False
gestión	True
contar	True
venta	True
ofrece	False
física	False
abajo	True
coche	True
diferencias	False
inversión	False
diálogo	False
calor	True
mamá	False
tarea	True
clases	False
constituye	False
personajes	True
casas	False
territorio	True
responsable	True
llevó	False
documento	False
cambiar	True
europeo	False
tono	False
internacionales	False
aguas	False
europea	False
pintura	True
intención	False
establecer	True
alcanzar	True
públicos	False
respeto	False
frío	True
influencia	True
pasos	False
literatura	False
fenómeno	False
nombres	False
asamblea	False
autores	False
ayuntamiento	False
comercial	True
dando	False
ritmo	True
pruebas	False
fines	False
estudiantes	False
necesita	False
audiencia	True
locales	False
técnicas	False
crítica	False
señala	False
conducta	False
ganar	True
afirma	False
actualidad	True
familiar	True
normas	True
triunfo	True
cumplir	False
empezó	False
leche	False
sábado	True
blanca	True
cabe	False
representación	False
labor	False
equipos	False
refiere	False
sensación	False
tradición	True
jugar	False
muertos	False
compañeros	True
sujeto	True
periódico	True
parecer	False
mantiene	False
competencia	False
profesor	True
alimentos	False
consecuencias	True
declaración	True
objetos	False
vecinos	True
pagar	False
mensaje	True
debate	True
iban	False
comer	False
referencia	False
quieren	False
hacerse	False
vi	False
declaró	False
pidió	False
definitiva	False
edificio	True
jornada	False
dicha	False
fondos	False
médicos	False
dificultades	True
simplemente	False
actos	True
aceite	True
vive	False
fig	False
plano	True
plantas	False
justo	True
posibles	False
representa	False
noticia	True
franco	False
prácticamente	False
versión	False
evidente	False
actuación	True
quedado	False
inmediato	False
miembro	True
tratar	False
suele	False
recién	False
niña	False
caer	False
ámbito	False
habitantes	True
llevaba	False
materiales	True
ausencia	True
fiesta	True
colegio	False
naciones	False
instante	True
brazo	True
áreas	False
corresponde	False
económicos	True
situaciones	False
escribir	False
llegada	True
ven	False
recibió	False
madera	True
federal	False
pleno	False
haga	False
ministros	True
pérdida	True
nota	True
museo	True
fase	False
provincia	True
velocidad	True
veía	False
institución	False
puertas	True
agentes	False
dispuesto	False
recibir	False
tamaño	False
tierras	False
transporte	False
próxima	True
decidió	False
habitación	True
tío	False
revista	True
explica	False
comunidades	False
autoridad	True
socialistas	True
década	True
personaje	True
escenario	False
corriente	True
mínimo	True
independencia	False
abierto	True
histórico	False
viento	True
escritor	True
presupuesto	True
convertido	True
organizaciones	False
tendencia	False
votos	False
secreto	True
acaba	False
anunció	False
produjo	False
operaciones	True
probablemente	False
familiares	True
alumnos	False
pelo	False
periodistas	False
conoce	False
esperanza	True
martes	False
vieja	False
antiguo	True
quiso	False
familias	False
posteriormente	False
reciente	True
división	True
cocina	True
pretende	False
entrevista	True
siguen	False
igualmente	False
piernas	True
reina	False
planta	True
identidad	True
aparte	False
completo	False
comienza	True
hacienda	False
comida	True
rato	False
alemán	True
presentó	False
naturales	False
verde	True
error	True
especies	False
barrio	True
piso	False
volumen	True
hojas	True
piensa	False
recordar	True
comportamiento	False
disposición	True
estrategia	True
necesaria	False
funcionamiento	False
compromiso	False
juegos	False
reacción	True
económicas	False
aparición	False
ingresos	True
abogado	True
oficina	False
consiste	False
parecen	False
cuidado	True
sentía	False
colores	False
soldados	True
recibido	True
elección	True
cárcel	False
pago	True
pequeñas	False
decisiones	False
piedra	True
incremento	True
liga	False
entra	False
distribución	True
suma	True
edición	True
trataba	False
procedimiento	True
iniciativa	False
logró	False
darle	False
poeta	True
cadena	False
sede	True
plata	True
jueves	False
utilizar	False
portavoz	False
similar	True
querido	False
ventana	True
quieres	False
deuda	False
regional	True
animal	True
canal	True
norteamericano	False
continuación	False
medicina	True
inglés	False
venido	False
privada	False
personalidad	True
federación	True
bienes	False
altos	False
parque	True
ataque	False
fe	False
abierta	True
preciso	False
tradicional	False
investigaciones	False
regiones	True
entidad	True
directa	False
enfermedades	True
firma	True
siglos	False
hermanos	True
seres	False
responsables	False
filosofía	True
sirve	False
temperatura	True
presentar	True
ropa	False
elemento	True
sombra	False
alianza	True
decidido	False
carga	True
extranjeros	False
santo	False
luna	False
causas	True
empresarios	False
figuras	False
permanente	False
método	True
huelga	False
marca	True
leer	False
oferta	True
margen	True
presentación	False
azul	True
noticias	True
acaso	False
acuerdos	False
búsqueda	False
tomó	False
constitucional	False
concepción	False
gobernador	True
aparecen	False
juntos	False
cuello	False
puestos	True
pobres	False
constante	True
bancos	True
resolver	True
quedan	False
comienzo	True
labios	True
contrato	True
hermana	True
abrir	False
logrado	True
matrimonio	True
frase	False
llegaron	False
hará	False
importa	False
morir	True
sorpresa	True
documentos	True
caja	False
gastos	True
generalmente	False
extremo	True
caída	True
pareja	False
bolsa	False
encontraba	False
masa	True
previsto	True
titular	False
clave	True
dormir	False
reducción	False
culpa	True
producido	False
menores	True
preocupación	True
terminar	True
miércoles	False
considerar	False
esfuerzos	False
preguntas	True
espectáculo	False
colaboración	True
mente	True
crédito	False
original	True
bases	True
feliz	True
democrática	False
hablando	False
negocio	True
llevado	False
oído	True
diputado	False
decreto	True
europeos	True
tecnología	True
plena	False
cartas	False
películas	False
detalles	False
sentir	False
sacar	True
dirigente	True
veo	False
graves	False
únicamente	False
vas	False
entrega	True
miró	False
corto	False
artista	True
vuelto	False
límites	True
impresión	False
negociaciones	False
caballo	False
planes	False
juventud	False
piezas	False
seguía	False
carretera	True
noches	False
negocios	False
mejorar	True
exteriores	False
inmediatamente	False
encontró	False
correspondiente	False
producir	False
técnicos	False
género	True
voto	False
serio	False
privado	True
actuales	False
equilibrio	True
indica	False
beneficios	True
artistas	False
llamar	False
salón	True
periodista	True
aceptar	False
ocurrido	False
perfectamente	False
integración	True
realiza	False
ocurrió	False
pienso	False
cifra	False
siento	False
misión	False
recuperación	True
explicar	False
respondió	True
vivo	True
unidades	False
conversación	True
cuerpos	False
generación	True
incluye	False
sonrisa	True
espalda	False
rojo	True
criterios	False
claramente	False
individuo	False
china	False
negra	True
cuentas	False
asegura	False
patria	False
corrupción	False
belleza	False
prisión	False
interna	False
pareció	False
pecho	False
habitual	False
papá	False
antigua	False
actor	True
comunista	False
víctimas	False
legal	True
segundos	False
establece	False
duro	True
tráfico	False
pacto	False
comprender	True
extranjero	False
requiere	True
dedos	True
azúcar	False
depende	False
fuertes	False
agencia	False
temor	False
interesante	True
campos	False
absoluta	False
físico	False
venía	False
realización	True
creer	False
gobiernos	False
jugador	True
especiales	False
organismos	True
resistencia	True
coronel	False
concentración	True
reconocimiento	True
negociación	False
aparato	False
universal	True
voces	True
perspectiva	True
pedir	True
recuerda	False
rápido	True
motivos	True
diciendo	False
alegría	False
lleno	False
murió	False
independiente	True
factor	False
sexual	True
sonido	True
estudiar	True
posiciones	False
espacios	False
histórica	False
mercados	False
cuadros	True
producen	False
poesía	False
musical	True
participar	False
vacío	True
lectura	True
seguramente	False
cuestiones	False
constituyen	False
banda	False
clima	True
inicial	False
democrático	True
inferior	True
dudas	False
publicidad	True
mirar	True
intelectual	False
vehículos	True
olvidar	False
actuar	True
alcance	False
partida	False
reconocer	False
papeles	False
capitán	False
sucede	True
latina	False
amplio	True
sexo	False
criterio	False
ganado	False
recurso	False
llevan	False
sesión	True
cooperación	True
laboral	False
compra	True
enseñanza	True
utilización	False
categoría	False
apertura	False
presentan	False
abrió	False
abre	False
solidaridad	True
amplia	True
francesa	False
numerosos	True
encontrado	False
empieza	True
lluvia	True
cifras	False
científico	False
ciencias	True
pide	False
directo	True
mostró	False
interpretación	True
forman	False
quedaba	False
formar	False
extraño	True
síntomas	True
punta	False
conseguido	False
determinado	False
liberación	False
sección	True
tensión	False
presentado	True
escala	False
conde	False
árboles	True
suelen	False
alcohol	True
culturales	False
hacían	False
seguido	True
posterior	True
llena	False
supo	False
empleados	False
ojo	True
dura	True
pasando	False
contexto	False
viejos	False
llamó	False
puesta	False
venir	False
inversiones	False
personales	False
presentes	False
instrumento	True
propuestas	True
máxima	False
populares	True
representante	True
células	False
hambre	True
artículos	True
científicos	False
elaboración	False
continuar	True
vicepresidente	True
esperaba	False
tía	False
significado	True
ventaja	False
quedar	False
resolución	False
pausa	False
basta	False
pensando	False
sindicatos	False
alternativa	True
amenaza	True
conversaciones	False
ruido	True
paro	False
jardín	False
código	False
convertirse	False
distinto	True
intensidad	False
madrugada	False
raíz	True
rápidamente	True
reales	False
pensó	False
métodos	True
servir	False
reducir	False
delito	True
completa	True
entró	False
batalla	True
sentencia	True
entorno	True
sociedades	False
negros	True
cita	False
instrumentos	True
semejante	False
españolas	False
vestido	True
turismo	True
construir	False
instalaciones	False
continúa	False
títulos	True
avión	True
comerciales	False
beneficio	True
norteamericana	False
mexicano	False
tasa	False
absoluto	False
candidatos	False
enfermo	False
dominio	True
excepción	False
órdenes	False
nuevamente	False
asesinato	True
pensaba	False
siguió	False
posee	False
completamente	False
escuchar	False
profunda	False
paredes	False
recientemente	False
manifestaciones	False
mirando	False
perdió	False
despacho	False
hablaba	False
ingreso	False
fórmula	False
empezar	False
inicio	True
múltiples	False
seguida	False
víctima	True
llegan	False
recordó	False
vehículo	False
sentimiento	False
mezcla	True
geografía	False
periodo	False
denuncia	True
moda	False
festival	True
vienen	False
espejo	False
pieza	False
expertos	False
convierte	False
comprar	False
drogas	True
príncipe	False
pared	True
dejando	False
registro	False
porcentaje	True
accidente	True
caliente	True
buscando	False
darse	False
ciclo	True
superiores	False
secretaría	False
capaces	True
nacido	True
argentino	False
muchacho	False
inició	False
di	False
lector	True
viva	False
postura	False
explicación	False
conviene	False
ganas	False
funcionario	True
profundo	True
críticas	True
honor	False
ideal	True
triste	False
placer	False
impuestos	True
sentimientos	True
altas	False
dientes	True
textos	False
acontecimientos	False
mecanismos	True
aumentar	True
composición	False
totalidad	False
foto	True
gas	False
comunes	False
tomado	False
agricultura	True
individuos	True
inteligencia	True
modelos	False
baño	True
considerado	False
opción	True
olor	False
índice	False
ganó	True
desarrollar	False
experiencias	True
cerebro	True
exige	False
horno	True
preparación	True
individual	False
moderna	False
habló	False
errores	False
estatal	False
haberse	False
depresión	True
armadas	False
policías	False
señalar	False
estructuras	False
entidades	False
italiano	True
consideran	False
esencial	False
firme	True
global	True
disco	False
supremo	False
absolutamente	False
cargos	False
fotografía	False
distinta	True
polvo	True
humor	False
pintor	True
conceptos	True
vasco	False
naturalmente	False
fracaso	False
recibe	True
complejo	True
acabar	False
abandonar	True
fundamentales	False
creciente	True
restos	True
conocida	False
terminó	False
minuto	False
excelente	True
regreso	True
página	False
discusión	True
déficit	False
ánimo	False
vale	False
reyes	False
numerosas	False
detenido	True
localidad	True
diseño	True
sintió	False
cumbre	False
sueños	True
impuesto	True
fundamentalmente	False
deporte	True
gloria	False
universo	True
convenio	True
pasión	True
jueces	True
luces	True
protesta	False
periódicos	False
estrellas	True
permiten	False
añade	False
definitivamente	False
conocimientos	False
concreto	False
elegido	True
recorrido	False
estación	False
compañero	True
lógica	False
comunicado	False
derrota	False
cierre	False
viven	False
definición	True
campesinos	False
límite	False
comprobar	False
parecido	False
dosis	True
esperando	False
exclusivamente	False
embajador	True
inflación	True
enemigo	False
interno	True
crimen	False
residencia	False
soledad	False
eficacia	False
respectivamente	False
paisaje	False
oír	False
tareas	True
costumbre	True
resultó	False
interesa	False
impacto	False
conocía	False
pasaba	False
estadounidense	False
religión	True
profesores	False
autonomía	False
exactamente	False
componentes	False
cayó	False
norteamericanos	False
asistencia	False
cambiado	True
probable	True
caminos	False
científica	True
duración	True
vías	False
manifestación	True
convirtió	False
malo	False
antiguos	False
obligado	False
enfermos	False
oscuro	True
pura	True
vaso	True
ofrecer	False
marcos	False
petróleo	True
reglas	False
invierno	True
máquina	False
reuniones	False
municipales	False
nacimiento	True
pedido	False
extensión	True
apareció	False
tesis	True
indios	False
vivienda	False
responde	False
pantalla	True
adecuada	True
paseo	False
determinar	False
utiliza	False
toro	False
presidencial	False
implica	False
acabó	False
salido	False
franceses	False
ejecución	False
puro	True
oye	False
consiguió	False
entiende	False
occidental	True
gasto	False
encontramos	False
imperio	True
superar	True
imaginación	True
estabilidad	True
rasgos	True
frontera	True
cubano	False
adecuado	True
gol	False
industriales	False
compañías	False
soluciones	True
catalán	True
marina	False
dificultad	True
trabajando	False
virtud	True
libres	False
observar	False
dirige	False
petición	True
potencia	True
correr	True
anual	False
signo	True
tren	False
órganos	True
propiedades	True
necesarios	False
responder	False
distrito	False
notable	False
clientes	False
mando	False
mecanismo	False
claridad	True
redacción	False
señal	True
actores	False
quiera	False
conclusión	False
ocupa	False
establecido	False
quedaron	False
creado	False
sentado	False
contiene	True
hierro	True
riqueza	True
detalle	True
positivo	False
auto	False
alcanza	False
senado	True
correspondientes	False
frecuente	True
promedio	True
pista	True
piedras	True
amistad	True
puente	True
hogar	False
daño	False
patio	False
otan	False
facultad	True
tropas	False
vuelo	False
demostrar	False
muchacha	False
reflexión	True
consideración	False
editorial	False
tradicionales	False
obligación	True
hipótesis	True
dejan	False
hecha	False
relato	True
llamaba	False
reconoce	False
similares	False
recuperar	True
costo	True
juzgado	False
eficaz	False
pensé	False
orquesta	True
permitió	False
descubrir	False
viviendas	False
gritos	False
poderes	True
ventas	False
fría	True
diagnóstico	True
realizada	False
utilizado	True
silla	True
publicado	True
rechazo	False
prácticas	False
corta	True
loco	False
debo	False
esquema	True
líderes	False
propone	False
desea	False
progreso	True
defender	False
borde	True
remedio	False
transformación	True
ayudar	False
cortes	False
mental	True
verse	False
fortuna	True
aeropuerto	True
escuelas	True
abuela	False
droga	True
levantó	False
exceso	True
disciplina	False
reformas	False
gana	False
delitos	False
difusión	True
hombros	False
elegir	False
tratando	False
planeta	True
mantenimiento	False
civiles	False
hice	False
afecta	True
pierde	False
dimensión	True
ponen	False
pobreza	True
establecimiento	False
prestigio	False
círculo	True
toros	True
transición	True
cumplimiento	False
crea	False
famoso	False
gentes	False
encargado	False
lentamente	False
avenida	False
satisfacción	True
matar	False
pase	False
aplicar	False
viajes	True
dictadura	False
acompañado	False
grados	False
obtuvo	False
colectivo	False
gracia	False
chica	False
indígenas	True
expresa	False
citado	True
cáncer	True
regresar	True
descenso	False
diarios	False
entusiasmo	True
respuestas	False
recuerdos	False
contestó	False
explotación	True
particulares	False
masas	False
manejo	True
sindicato	True
financiero	True
protagonista	False
conflictos	False
aprobación	True
pasan	False
dueño	True
armada	False
telefónica	False
formado	True
sabido	False
dedicado	False
presos	False
controlar	True
consciente	True
liberal	False
conveniente	False
nació	False
dejaba	False
centrales	False
mediados	False
agente	True
montaña	False
publicación	True
cerrar	False
seno	False
dirigido	False
investigadores	True
torneo	True
útil	False
playa	False
lógico	True
subir	True
iniciar	True
escribe	False
golpes	False
próximas	False
terminado	True
universidades	False
revolucionario	False
metro	True
tabla	True
atentado	False
llamadas	False
polémica	False
crítico	True
quisiera	False
particularmente	False
atmósfera	True
descubierto	False
avance	True
evidencia	True
estadio	True
cerrado	True
efectivamente	False
inmediata	False
circulación	True
detenidos	False
dolores	True
apartado	False
anda	False
reconoció	False
muestran	False
dulce	False
escribió	False
terrible	False
permitir	False
campeón	False
gustaría	False
manifiesto	False
asegurar	False
feria	True
trato	False
números	True
edificios	True
extraña	False
determinados	False
señores	False
taza	False
católica	True
fenómenos	False
dada	False
moderno	False
barco	False
ingredientes	True
vender	False
empresario	False
humanidad	True
fácilmente	False
actitudes	False
diga	False
décadas	False
infancia	True
comunicaciones	False
consulta	False
rumbo	False
eléctrica	True
bajar	True
ejemplos	False
blancos	False
legislación	True
llaman	False
ponerse	False
rápida	False
entero	True
rueda	True
mantuvo	False
contó	False
creen	False
campeonato	True
demostrado	False
sustancias	True
necesarias	False
levanta	False
letras	True
andar	True
termina	False
sierra	False
instalación	False
árbol	True
alimentación	True
esquina	False
mexicanos	False
expansión	True
mejora	False
vacaciones	True
alcanzado	False
clasificación	True
reloj	False
huevos	False
banca	False
ciudadano	True
alcanzó	False
raíces	False
deseos	False
impulso	False
comenzar	False
dispone	False
órgano	False
arena	True
opiniones	False
procedimientos	False
maestros	False
anteriormente	False
moneda	True
comandante	False
fiestas	False
viendo	False
creía	False
jefes	False
homenaje	False
cadáver	False
gravedad	True
cantidades	False
siguiendo	False
especialistas	False
informa	False
demuestra	False
advirtió	False
intelectuales	False
signos	True
largas	False
escándalo	False
bajas	False
sensibilidad	False
lágrimas	True
suficientes	False
estancia	True
profundidad	False
argumento	True
comenzaron	False
mostrar	True
tabaco	True
conocidos	False
concurso	True
pertenece	False
largos	False
angustia	False
analizar	True
inicia	True
observa	False
presupuestos	True
tercero	False
aprender	True
dirigida	False
terrorismo	False
llegaba	False
vemos	False
evaluación	True
felicidad	False
socios	False
diría	False
existentes	False
oscuridad	False
manifiesta	False
radical	False
elevado	True
ventajas	True
anuncio	False
arma	True
ceremonia	True
virus	False
colección	False
pude	False
afirmar	False
previamente	False
brillante	False
aparecer	False
comunistas	False
permiso	True
vivido	False
cena	False
dependencia	True
potencial	True
norma	True
ampliación	True
sufrido	False
combate	False
situado	True
cuesta	False
caballos	True
recientes	False
mantienen	False
teniente	False
traje	False
actuaciones	False
impedir	True
proporción	True
corona	True
clásico	False
motor	True
parecían	False
dignidad	False
contenidos	False
dé	False
biblioteca	True
argumentos	True
negativa	False
humo	True
senador	True
corrientes	False
deportivo	True
galería	False
suave	True
colonia	True
concierto	False
rival	False
activa	False
preparado	True
negó	False
escasa	False
continuidad	False
ópera	False
espero	False
toneladas	False
iguales	False
historias	False
decirle	False
definir	True
comisiones	False
aventura	False
comprensión	True
convocatoria	False
artes	False
dedo	False
profesión	True
plantea	False
determinada	False
miraba	False
difíciles	False
provincial	True
canciones	False
oportunidades	False
solar	True
coalición	True
descanso	True
hablado	False
representan	False
promoción	False
reducido	False
aprendizaje	True
cultivo	True
continente	True
chico	False
fechas	False
cubrir	False
síntesis	False
hiciera	False
débil	True
urbano	True
infantil	True
tomando	False
provincias	True
cuentan	False
arquitectura	True
mínima	False
integrantes	False
estrella	False
orientación	False
meta	False
destrucción	True
enemigos	False
pendiente	False
electorales	False
primavera	True
automóvil	True
confusión	True
productores	True
vidas	False
tocar	False
ricos	False
financiación	False
panorama	True
ofreció	False
proteínas	True
permitido	True
abuelo	False
británico	True
relativamente	False
vital	False
sufrir	False
dispuestos	False
celebración	True
eje	False
frecuentes	False
nervioso	False
haría	False
capa	True
atender	False
vivía	False
legales	False
determinadas	False
anoche	False
disminución	False
existir	False
abogados	False
afuera	False
curiosidad	True
variedad	False
mediodía	False
obreros	False
contactos	False
dirigió	False
nariz	False
previa	False
ernesto	False
embajada	False
patrimonio	False
necesitan	False
dejaron	False
afectados	True
reservas	True
créditos	False
sacó	False
romper	False
emoción	False
jurídica	False
risa	False
letra	True
informes	False
oficinas	False
pérdidas	False
vueltas	False
desaparición	False
bandera	True
consejero	False
jurídico	False
formal	True
llamados	False
gira	False
castellano	False
conforme	False
comentarios	False
mexicana	False
acusado	False
notas	False
heridos	False
aumenta	False
utilizan	False
externa	False
reserva	False
responsabilidades	False
pensado	False
núcleo	False
programación	True
sencillo	True
riesgos	True
observación	True
religiosa	False
colectiva	False
cae	False
facilidad	False
amiga	False
frases	False
regular	True
logra	False
dioses	False
símbolo	False
destaca	False
característica	True
mensajes	False
quedarse	False
mandato	True
vivos	True
suficientemente	False
ilusión	True
consenso	False
necesariamente	False
malos	False
cura	False
acababa	False
intentó	False
dimensiones	True
asumir	False
circunstancia	False
fama	False
inútil	False
emperador	True
desaparecido	False
tiro	False
canción	True
venga	False
verdes	False
harina	False
básicos	False
testigos	False
sombras	False
fruto	True
bar	False
espectadores	False
igualdad	False
costumbres	True
relacionados	True
sabor	False
oeste	False
llevaron	False
precisa	True
posesión	True
delegación	False
tasas	False
sostiene	False
ofrecen	False
privadas	False
huesos	True
decidir	False
plato	True
permita	False
setenta	True
ponía	False
hoja	False
convencido	False
reglamento	False
ves	False
vigor	False
financieros	False
aviones	True
insistió	False
lujo	False
policial	False
segura	True
columna	True
ataques	False
corresponsal	False
escritores	False
ramas	True
ácido	False
percepción	True
incluyendo	False
león	False
merece	False
perros	True
presiones	False
destacar	False
provocar	False
beber	True
rigor	False
obtenido	True
mueve	False
plazas	False
etapas	True
dato	True
contratos	False
vigilancia	True
dará	False
sucedido	False
temporal	True
utilizando	False
esencia	False
toca	False
secretos	True
eliminar	True
botella	False
guerrilla	False
grito	False
torre	False
kilos	False
fotografías	False
desarrolla	False
tranquilo	True
monte	False
sujetos	False
caído	False
detuvo	False
daños	False
idioma	False
preparar	False
alemanes	True
dieta	False
añadir	False
firmado	False
perfecto	True
europeas	False
vieron	False
muestras	True
renuncia	True
narcotráfico	False
ordenó	False
favorable	False
rendimiento	False
xx	False
artística	False
dinámica	False
líquido	True
financiera	False
obliga	True
siquiera	False
clínica	False
conclusiones	False
reacciones	False
deber	True
turno	False
terrenos	False
realizan	False
provoca	False
exigencias	False
calma	False
sentirse	False
garantizar	False
llorar	False
intercambio	True
conservación	True
autónoma	True
blancas	False
levantar	False
desarrollado	False
intensa	False
disposiciones	False
enviado	True
salía	False
odio	True
pescado	True
fiscales	False
olvidado	False
examen	True
existía	False
americano	False
vecino	True
opciones	True
roja	False
multitud	True
zapatos	True
precisión	False
cuarta	True
canto	False
usuarios	False
desconocido	False
coches	False
gustaba	False
seco	True
unidas	True
daban	False
imprescindible	False
revisión	False
asociaciones	False
salarios	True
destacó	False
realizadas	False
baile	True
chicos	False
privados	False
entrenador	True
organizado	True
salto	True
orgullo	True
positiva	False
verdaderamente	False
conocen	False
estima	False
contaba	False
raro	False
materias	False
sufrió	False
emisión	False
carreras	True
testigo	True
cristal	True
profundamente	False
retrato	True
danza	True
existente	True
curioso	True
revistas	False
ética	False
ideología	False
ruptura	False
identificación	True
informaciones	False
lento	True
suponer	False
castigo	False
ruta	True
cursos	False
hombro	False
tel	False
goles	False
cumple	False
colocar	True
exportaciones	False
deportes	False
sirven	False
separación	True
nuclear	True
confirmó	False
perfil	False
estética	False
misterio	False
apariencia	False
seguros	False
irse	False
adquirir	False
femenina	False
respaldo	False
península	False
modificaciones	False
procedentes	False
horizonte	False
surge	False
bienestar	True
invitados	False
imaginar	False
uniforme	False
aparentemente	False
condena	False
detención	True
asiento	True
individuales	False
camisa	False
tragedia	False
temperaturas	True
muchachos	False
señales	True
fronteras	False
sienta	False
alternativas	True
hagan	False
santos	True
tendencias	False
comparación	True
bomba	False
expectativas	True
tve	False
rodillas	False
unida	True
testimonio	True
montañas	True
desgracia	False
alemana	False
acercó	False
salen	True
cometido	False
trató	False
publicó	False
participantes	False
ciertamente	False
ventanas	True
caminar	False
encontrarse	False
terroristas	False
institucional	True
templo	True
contaminación	False
bajos	False
clásica	False
escalera	True
médica	False
cercano	True
sustancia	False
protagonistas	True
religioso	False
visitar	False
paquete	True
demandas	False
enormes	False
ligeramente	False
sufre	False
humedad	False
juega	False
heridas	False
recoger	False
candidatura	True
actúa	False
queso	True
ejemplares	False
laboratorio	True
permanecer	False
tienda	True
auténtico	False
claras	True
cantante	True
definitivo	False
tristeza	False
lados	False
bloque	False
parlamentarios	False
obispo	True
concesión	False
vergüenza	False
aprobado	False
defensor	True
enfrentamiento	False
solicitud	False
socialismo	False
refleja	False
halla	False
trayectoria	True
espaldas	True
secuestro	True
ayudas	False
diablo	False
luchar	False
sindical	True
salvar	False
inevitable	True
cebolla	True
cumplido	True
recoge	False
suspensión	False
ocupar	False
capitales	True
tiende	False
alza	False
gris	True
descripción	False
finalidad	False
dólar	False
comienzos	False
actriz	True
peligroso	True
gestos	True
coste	False
garantía	True
auténtica	False
entera	False
alimento	True
femenino	False
verlo	False
cola	False
echar	False
posiblemente	False
amparo	False
prima	False
provocado	False
maíz	False
reflejo	False
asistir	False
mantenido	False
hilo	False
previo	True
impide	False
infraestructura	False
urgencia	True
tranquilidad	True
xviii	True
intenso	False
poblaciones	False
facilitar	True
inmensa	False
nieve	True
intenciones	False
islas	True
conozco	False
presidentes	False
permitirá	False
terror	False
corre	False
ap	False
hacerle	False
provocó	False
fiel	False
destinado	False
afirmación	True
tejido	False
bolsillo	False
acudir	False
incorporación	False
antecedentes	True
extremos	True
amante	False
municipio	False
supongo	True
negociar	True
bosques	False
vocación	False
normalmente	False
piano	True
llegue	False
instrucciones	True
cerró	False
huevo	False
intentos	True
cubanos	False
granada	False
comprende	False
decían	False
espectador	False
cabezas	False
señalado	False
cámaras	False
pasajeros	True
balance	True
sindicales	False
viejas	False
conduce	False
fábrica	False
plenamente	False
domicilio	True
aceptación	False
relativa	True
instancia	False
vigente	False
km	False
ensayo	True
lectores	False
necesitaba	False
terrorista	True
regionales	False
corresponden	False
cubierta	False
dichos	False
iniciado	False
extrema	False
competencias	False
ejercer	False
adiós	False
accidentes	False
humanas	False
irán	False
obligaciones	False
acusaciones	False
oriente	False
mentira	False
rico	True
caras	True
tela	True
fija	True
votación	True
específico	False
pasaron	False
negativo	True
leído	False
cadenas	False
quede	False
emergencia	True
subida	True
compromisos	False
canales	True
premios	False
cerrada	False
incluido	False
comentario	True
quinto	False
singular	True
avances	True
pelota	True
teorías	False
regla	False
pierna	True
parar	True
entrado	False
compuesto	True
concluyó	False
convivencia	False
posteriores	False
corriendo	False
decirse	False
poniendo	False
guía	True
ansiedad	True
empresarial	False
inteligente	True
hermosa	False
propuso	False
volvía	False
continuó	False
generaciones	False
independientes	False
empezaron	False
agrega	False
resultaba	False
comenzado	False
amenazas	False
gubernamental	False
épocas	False
acceder	False
encontraban	False
olvido	True
conoció	False
cambia	True
talento	True
evidentemente	False
empleado	True
rural	True
ambiental	True
entregó	False
efectivo	True
sirvió	False
esperan	False
vanguardia	False
aprovechar	False
cm	False
críticos	False
considerable	False
cero	True
ocurrir	True
desierto	True
músculos	True
literaria	True
exilio	True
escrita	False
explicaciones	True
propuesto	False
nubes	True
funciona	False
colombiano	False
espiritual	True
encontraron	False
entiendo	False
repetir	True
descubrió	False
pusieron	False
adaptación	True
espectacular	False
ríos	False
condenado	False
fotos	False
azules	False
encuentros	False
contraste	False
simples	False
adentro	False
cliente	True
desempleo	False
italiana	True
dices	False
sesiones	False
planos	False
escolar	True
liberales	False
adultos	False
izquierdo	True
extraordinaria	False
salsa	True
advierte	False
tarjeta	False
represión	True
et	False
tesoro	True
locura	False
abundante	True
socio	True
modificar	False
comisario	False
novia	False
caza	True
activo	True
abiertos	False
proyección	False
cubana	False
directores	False
combatir	False
doctrina	False
realizados	False
querían	False
lesiones	True
define	False
distinguir	False
municipios	False
urss	False
abandono	False
adoptar	False
ruso	False
medicamentos	True
explosión	True
renovación	False
perfecta	True
expresar	False
química	True
transmisión	True
modificación	True
concluir	False
pensamientos	True
convertir	True
restantes	False
alteraciones	True
sostuvo	False
trae	False
niega	False
corporación	False
determinación	False
equivalente	True
viviendo	False
internos	False
artístico	True
lanzó	False
urbana	True
rapidez	False
sombrero	True
roca	False
estómago	False
ronda	False
paciencia	True
escapar	False
poema	True
listas	False
apoyar	True
debilidad	True
escritos	False
viajar	True
miseria	False
indispensable	True
visitas	True
otoño	False
plástico	False
ocupación	True
veremos	False
combinación	False
magnitud	False
activos	True
permanece	False
acá	False
ejemplar	False
enfrentar	True
fusión	True
declarar	False
básica	False
cantar	False
limpieza	True
herencia	False
desaparecer	False
poseen	False
pilar	False
extraordinario	True
raza	False
misa	False
cariño	True
resultar	False
aficionados	False
decide	False
culto	True
utilidad	False
deterioro	False
flor	True
escenas	False
sucedió	False
reconocido	False
falso	True
soberanía	False
situada	False
introducir	False
ingeniero	True
efectuar	False
abandonado	False
aniversario	True
filas	False
parlamentario	True
aceptó	False
turistas	False
restaurante	True
incidencia	True
tránsito	False
rojas	False
dibujo	False
vigencia	False
aparente	True
afán	False
retirada	True
frutas	True
documentación	True
parcial	True
prisa	False
pagos	False
denominado	False
trastornos	False
personalmente	False
garantías	False
jurado	False
recurrir	False
incapaz	True
sentí	False
conquista	True
seguirá	False
envió	False
escritura	True
sacrificio	False
tribunales	False
impone	False
saca	False
comando	True
rincón	False
costado	False
concreta	False
sonidos	True
regulación	False
soldado	True
oficialmente	False
acusación	False
infección	False
versiones	True
prevista	False
convicción	False
celebrar	True
sitúa	False
normales	False
perspectivas	True
ucd	False
finanzas	False
anuales	False
introducción	True
sexuales	False
novelas	False
esposo	False
propietarios	False
discutir	False
patrón	True
declarado	True
resultan	False
crees	False
anunciado	False
imponer	False
redes	True
históricos	False
reciben	False
retorno	False
expresiones	False
gerente	True
pistola	False
renta	False
pasillo	True
significativo	False
buscan	False
planificación	True
bruselas	False
versos	False
novedad	True
constantemente	False
máquinas	False
censura	True
sencilla	False
art	False
frutos	True
organizar	True
resumen	True
visitantes	False
policiales	False
planteamiento	False
bella	False
oscura	False
nombrado	True
calificó	False
herido	False
conductor	False
delegado	False
poemas	False
músicos	False
argentinos	False
negras	False
enfoque	False
amarillo	False
caracteriza	False
incluyen	False
corporal	True
considerarse	False
escucha	True
entrenamiento	True
sumamente	False
reparto	False
costos	True
expediente	False
diversidad	True
síndrome	False
colegas	False
gritó	False
continua	False
coordinación	False
cajas	False
acepta	False
ejecutiva	False
balón	False
madres	False
aparatos	False
relieve	False
urgente	True
penas	True
parlamentaria	False
avanzar	True
sitios	False
gramos	False
fresco	False
jugando	False
propietario	True
muebles	True
pendientes	False
espacial	True
despertar	False
carreteras	False
episodio	False
salieron	False
mencionado	False
proteger	True
disponer	False
nacionalistas	False
milagro	False
promover	False
directivos	False
salario	True
limitaciones	True
burguesía	False
efectiva	False
judiciales	False
viuda	False
variable	True
decirlo	False
barrios	True
bellas	False
servido	False
centímetros	False
alturas	True
platos	True
piloto	False
sometido	False
automóviles	False
fiebre	False
únicos	False
llegando	False
británica	False
longitud	False
circular	True
correcta	False
cartera	False
herida	False
echó	False
muerta	False
obtiene	False
ajuste	False
vientre	False
arco	False
formando	False
judíos	False
aprobó	False
grasa	False
semejantes	False
agrícola	False
soportar	False
sensible	True
inferiores	False
basada	False
territorios	False
antiguas	False
cualidades	True
fuga	False
contado	False
musicales	False
estrecha	False
sospecha	True
metido	False
culturas	False
ancho	False
sucesos	False
visible	True
esperanzas	False
adquisición	True
vidrio	True
prepara	False
chileno	False
celebrado	False
preocupa	False
circuito	False
intervenir	True
sorprendente	False
pinturas	False
guardias	False
físicas	False
respiración	True
adn	True
rayos	True
pertenecen	False
elaborado	False
basa	False
oreja	True
ajo	False
barcos	False
mire	False
requisitos	True
ocupado	True
muro	False
integral	False
dichas	False
solitario	True
palma	False
fallo	False
recinto	False
escaso	True
medias	False
poetas	False
culpable	False
agradable	False
piensan	False
directiva	False
consumidores	False
abiertas	False
nombramiento	False
gato	True
indígena	True
fabricación	True
vuelven	False
incluir	True
cambió	False
dibujos	False
empezado	False
marcado	False
señorita	False
contemplar	False
india	False
recordaba	False
xvii	True
comicios	False
coloca	False
crónica	False
autorización	False
rocas	False
laborales	False
malas	False
incendio	True
estable	True
boda	False
traslado	True
embarazo	False
creó	False
caldo	False
dispuesta	False
variables	False
ilegal	True
monarquía	True
denuncias	False
mapa	True
absurdo	False
interesados	False
afectan	False
vientos	False
acontecimiento	False
regalo	True
ordenador	True
estatales	False
ingleses	False
estudiante	False
hábitos	True
perdida	False
conservar	True
famosa	False
continuo	True
hospitales	False
habilidad	True
ahorro	True
básico	False
referencias	False
cintura	False
cotidiana	False
duró	False
presentarse	False
lenguas	True
ejercicios	False
alicia	False
basura	True
hijas	False
fórmulas	False
miel	False
indican	False
trabajador	True
deje	False
acabado	False
cristianos	False
mesas	True
cerveza	False
ampliar	True
aclarar	False
catalana	False
aceptado	False
oriental	False
vivió	False
contempla	False
públicamente	False
esclavos	False
crecer	False
colaboradores	True
prevé	False
infierno	True
interesado	True
afectado	False
verá	False
salas	True
atractivo	True
religiosas	False
presentada	False
relacionadas	False
pecado	False
cigarrillo	False
sillón	False
integrado	False
eliminación	True
juvenil	True
llave	False
revela	False
realizará	False
mostrado	False
campañas	True
encuesta	True
habituales	False
bajó	False
basado	False
té	True
siga	False
poderoso	True
civilización	False
valoración	True
estaciones	True
certeza	False
justamente	False
récord	False
leve	False
incidente	False
transportes	False
esenciales	False
toman	False
refugio	True
limón	False
inquietud	False
impuso	False
consta	False
cierra	False
ajeno	False
regresó	False
específica	False
citada	False
sienten	False
internas	False
tarifas	False
utilizados	False
cálculo	False
lenta	False
faltaba	False
nave	False
oxígeno	False
jornadas	False
habitaciones	False
complejidad	True
dirigir	False
sustitución	True
identificar	False
torres	True
italianos	False
nervios	False
producirse	False
azar	False
guerras	False
militantes	False
futura	False
americanos	False
representar	False
sacerdote	True
construido	True
físicos	False
conexión	False
observaciones	False
recepción	True
guarda	False
cuartos	False
llevando	False
figuran	False
calendario	False
vencer	True
estímulo	False
propaganda	True
concretos	False
exclusiva	False
compartir	False
aliento	False
suiza	False
cercana	False
significación	False
llevaban	False
seca	True
extranjera	False
evento	False
agresión	True
entradas	False
considerada	True
sanciones	True
taller	True
ascenso	False
une	False
maneras	False
guión	False
destinados	False
destacan	False
insiste	False
retraso	False
adolescente	True
árabe	True
leyenda	True
dimisión	False
eco	True
ensayos	False
revés	False
americana	False
admiración	True
variaciones	False
marcas	False
evita	False
hermoso	False
niñas	False
exportación	True
lograron	False
dominante	True
solicitar	True
beso	False
estrictamente	False
plantilla	False
mariana	False
libertades	True
literario	False
pájaros	False
categorías	False
doy	False
disfrutar	False
perfección	True
cancha	False
adquiere	False
excesiva	False
períodos	False
conserva	False
anuncia	False
mierda	False
suprema	False
asistentes	False
entregar	False
crema	False
pregunté	False
específicos	False
investigar	False
personalidades	False
extiende	False
parejas	True
verla	False
dormido	True
denomina	False
creador	True
decenas	False
falsa	False
toque	False
nace	False
carbón	False
catalanes	True
componente	True
rara	False
oyó	False
contribuir	False
suceso	False
cobertura	False
financieras	False
venían	False
cubierto	False
comerciantes	False
consideraba	False
alegre	False
héroe	False
brasileño	False
enviar	True
compositor	True
soporte	False
seria	False
fantasía	False
montaje	True
generar	True
guerrilleros	False
ofensiva	False
racional	False
camión	True
aplica	True
espada	True
celebró	False
obtenidos	False
invasión	False
respectivos	False
puta	False
industrias	False
sucesión	False
visual	True
acumulación	True
afición	False
rica	False
entendido	False
excepcional	True
trimestre	True
facultades	True
aliados	False
armado	True
concretas	False
cuerda	False
justificar	False
muere	False
paga	False
fundamento	False
limpia	True
orilla	False
pensiones	False
correcto	True
consejos	False
sentarse	True
increíble	False
rango	True
inocente	False
presentaron	False
compleja	False
mantenerse	False
relativo	False
genera	False
decidieron	False
cementerio	True
tratados	False
renunciar	True
empezaba	False
reduce	False
irá	False
relacionado	False
genes	False
hielo	True
prevención	True
elevada	False
noble	False
vegetales	True
señalan	False
primaria	True
tecnologías	True
externo	True
sepa	False
transcurso	False
sueldo	True
quedará	False
frecuentemente	True
conocidas	False
rock	False
aviso	True
asalto	False
abandonó	False
delegados	False
decisivo	False
pasados	True
discursos	False
supervivencia	False
duras	False
perdón	False
estadounidenses	True
recibieron	False
orejas	True
invitado	True
emisoras	False
selva	True
satisfacer	False
distinción	True
fases	False
vestidos	False
indicar	False
canciller	False
subió	False
refugiados	False
cortar	False
reto	False
fraude	True
orgánica	False
juntas	False
tocó	False
fiscalía	False
ruedas	True
mito	False
interesantes	False
labores	False
capitalismo	True
sorprendido	True
gubernamentales	False
cansancio	False
inicialmente	False
lejano	False
recorrer	False
sabían	False
bandas	False
normativa	False
rabia	False
reproducción	True
conducir	True
célebre	False
seguimiento	False
roto	False
quedaban	False
proceder	False
rama	True
genética	True
intimidad	False
hechas	False
dedica	False
universitarios	False
cuenca	False
cuadrados	False
solía	False
colombianos	False
administrativa	True
entrevistas	False
armados	False
exigir	True
drama	False
vea	False
requieren	False
caballero	False
coinciden	False
colonial	True
básicamente	False
filme	True
tratan	False
adquirido	True
aves	False
religiosos	False
tensiones	True
densidad	True
carece	False
intérpretes	False
sube	False
clásicos	False
surgió	False
cuartel	True
cuentos	False
apunta	False
hallaba	False
emisora	False
duros	False
comienzan	False
lesión	True
ángulo	False
llamas	False
barro	False
asesinado	False
quedando	False
derivados	False
minerales	True
quinta	False
originales	False
madrileño	False
rumores	False
tramo	False
afrontar	False
muros	True
entendimiento	False
repite	True
básicas	False
barra	False
miradas	False
nacer	False
efectivos	False
tumba	False
extranjeras	False
correo	True
desnudo	False
aseguran	False
hectáreas	False
dedicada	False
pasta	False
simultáneamente	False
iniciativas	False
probar	False
subrayó	False
lanza	True
almuerzo	True
docentes	False
planteamientos	False
bahía	False
cuota	True
inglesa	False
vano	False
educativo	True
horror	False
seguidores	False
publicada	False
rojos	False
permanencia	False
protestas	True
procedente	False
cristiana	True
virtudes	False
piden	False
pelea	False
casado	True
diaria	False
amo	False
metal	True
permitía	False
secuencia	True
fila	True
prd	False
concejal	False
importaciones	True
harán	False
párrafo	False
dormitorio	True
oculta	False
detener	True
carro	False
tiendas	False
admite	False
supuestos	False
aprendido	True
estudia	True
habitualmente	False
curva	True
crece	False
loca	False
incertidumbre	True
magistrado	True
cartel	False
limpio	True
murieron	False
aplicaciones	True
limitado	True
listo	False
dueños	False
apoya	False
estrategias	False
presunto	False
privatización	True
formada	False
elegante	True
tranquila	False
pretendía	False
incluidos	False
and	False
detiene	False
comedor	False
conservador	True
peculiar	False
celebra	False
resultaron	False
procede	False
teatral	False
tronco	False
chino	False
vascos	True
empeño	False
tercio	False
irregularidades	False
precisó	False
lluvias	False
trajo	False
kg	False
vapor	True
monetaria	False
razonable	True
propiamente	False
cristales	False
tejidos	False
corredor	False
exigencia	False
nerviosa	False
promesa	True
quito	False
deseaba	False
costes	True
criminal	False
cinta	False
alumno	False
encuestas	False
conciertos	False
ganador	True
traído	False
especialista	True
cucharada	False
aparecía	False
incapacidad	True
choque	True
garganta	False
invitación	False
venezolano	True
pretenden	False
productividad	True
separado	False
específicas	False
mantenía	False
robo	True
elaborar	False
preguntar	False
arquitecto	True
asombro	False
mentales	False
respetar	False
patas	True
felices	False
bailar	False
mecánica	True
constantes	False
cadáveres	False
unido	False
disminuir	False
bosnia	False
constituido	False
participaron	False
demostró	False
moverse	False
tardes	False
diera	False
hermanas	False
manteca	False
destacado	False
aporte	False
censo	True
adolescentes	False
recta	True
profundas	False
cálculos	False
supuesta	False
comenta	False
aislamiento	False
manolo	False
juzgar	False
acercarse	True
informar	False
jugo	True
estableció	False
huir	False
dama	False
amanecer	True
notar	False
intentando	False
registrado	True
occidentales	False
vayan	False
rostros	False
interpretar	False
satisfecho	False
definido	False
genio	True
notables	True
positivos	False
atlántico	False
tentación	False
entregado	False
secretaria	True
proporciona	False
colegios	False
costas	True
discos	False
informaron	False
enfrenta	False
acusa	False
capítulos	True
mínimos	False
inés	False
celebrada	False
traer	False
israelí	False
pintores	False
clubes	False
provisional	False
entran	False
alarma	False
empate	True
firmas	False
obligados	False
incidentes	False
cuchillo	False
agrícolas	False
trama	False
oral	True
actúan	False
referente	True
instantes	False
giro	True
presa	False
acusados	False
opuesto	True
publicaciones	False
cucharadas	False
parto	False
supuestamente	False
oídos	False
noción	False
directora	False
productor	True
cuero	True
ciudadanía	False
claves	True
combustible	True
obstáculos	True
esfera	True
cocción	True
caracteres	False
modos	False
sabiduría	True
apreciar	False
constituir	False
contienen	False
negar	True
copia	True
modalidad	False
preocupado	True
sorprendió	False
jardines	False
prefiere	False
fieles	False
ocupan	False
permitan	False
problemática	True
partidarios	False
instrucción	True
acento	False
eléctrico	False
oscuras	False
describe	True
indiferencia	True
volvieron	False
sufren	False
participan	False
emociones	True
llevará	False
griego	True
desastre	False
columnas	True
reuter	False
referirse	False
citar	False
acompaña	False
faltan	False
terrestre	True
determina	False
mínimas	False
quita	False
realizando	False
sudor	True
colectivos	False
creyó	False
mencionar	False
semillas	True
ficción	True
ocultar	False
iniciales	True
resuelto	False
nacionalista	False
comedia	True
contemporánea	False
dedicó	False
integran	False
establecimientos	False
sentó	False
manifestado	False
fachada	True
verdaderos	False
monto	False
inmenso	False
inspiración	False
enfrentarse	False
asesor	True
morales	False
obligó	False
creada	False
intervenciones	False
ternura	False
cansado	False
útiles	False
vuelva	False
rodeado	False
ama	False
aportación	False
exista	False
artificial	True
seguían	False
hueso	False
reír	False
firmar	False
planteado	False
desesperación	True
estímulos	False
accionistas	True
cruzar	False
montón	False
fantasma	False
lección	False
tocado	False
nacionalidad	False
presentará	False
sufrimiento	False
cerro	False
encontré	False
votar	True
broma	False
rol	True
afecto	True
funcional	False
alba	True
fijo	False
orígenes	False
vertical	True
suicidio	True
guardar	False
mandatario	False
defectos	False
psicología	False
escultura	False
perdiendo	False
correspondencia	False
pedía	False
académico	False
ancianos	False
pesca	True
soviético	False
peruano	False
electricidad	False
bebé	False
vasos	False
coro	True
cobrar	False
estadísticas	True
alteración	True
postre	True
medir	False
buscaba	False
desarrollados	False
intentado	False
siguieron	False
alcaldía	False
complicado	True
asilo	True
colocado	False
contento	False
hueco	True
flujo	False
andaba	False
bordo	False
obtención	False
índole	False
justa	True
estudiado	False
peores	False
produciendo	False
sentada	False
solucionar	True
capitalista	False
influencias	False
delincuentes	False
complejos	True
capas	True
comidas	False
conocemos	False
ponga	False
informado	False
celebrará	False
organizada	False
gustan	False
vegetal	True
film	False
caos	True
funcionar	False
desafío	False
claros	True
meter	False
indio	False
tormenta	False
territorial	False
diana	True
traducción	True
alas	True
trate	False
finca	True
propósitos	False
acusó	False
acaban	False
respectivas	False
finalizar	True
rosario	False
fuertemente	False
ofertas	True
instalado	False
violación	True
contribución	True
torero	False
ajena	False
partículas	True
trabajado	False
madurez	True
lateral	True
tomaron	False
solicitó	False
inmigrantes	False
masiva	False
instancias	False
mandó	False
consideraciones	False
horario	True
empiezan	False
incrementar	True
pidiendo	False
confederación	False
echa	False
cultivos	False
inspección	False
ámbitos	False
publica	False
celular	False
gobernar	True
trabajaba	False
cocaína	False
agencias	False
terapia	True
aprobada	False
miran	False
manejar	False
direcciones	False
sexto	False
escaleras	False
usos	False
árabes	True
taxi	True
representaciones	True
importe	False
solicitado	False
acero	False
llegaban	False
impresionante	False
altamente	False
círculos	False
chilenos	False
modernos	False
mediterráneo	False
agenda	True
rebeldes	False
picado	True
experto	True
realizaron	False
realizarse	False
balcón	False
tablas	False
difícilmente	False
lecho	False
reunió	False
monedas	True
clarín	False
precedentes	False
llegará	False
plataforma	False
teórico	False
vegetación	False
coincide	False
jugó	False
nucleares	False
vimos	False
conservadores	False
cabello	True
fortaleza	False
ignorancia	False
contener	False
suceder	False
preso	False
litros	False
maniobra	True
latinoamericanos	False
mera	False
anciano	True
refirió	False
excesivo	False
compras	True
den	False
concluye	False
persecución	False
prado	False
cable	False
saco	False
camiones	False
pantalones	False
denominada	False
tomate	False
captura	False
medalla	True
brillantes	False
inauguración	False
abundancia	True
aspiraciones	False
diplomático	True
implantación	False
supera	False
cumplen	False
ridículo	False
completar	True
optimismo	False
hoteles	False
malestar	True
varones	False
titulares	False
éxitos	False
advertir	True
venganza	False
ampliamente	False
bebidas	False
desnuda	False
deriva	False
licencia	True
emocional	True
sonrió	False
docena	False
admitir	False
centroamérica	False
fina	False
saberlo	False
desprecio	False
contradicciones	True
contradicción	True
convencer	True
énfasis	True
entraba	False
integrada	True
cobre	True
pasará	False
concretamente	False
llegué	False
males	False
defiende	False
bonito	True
copas	False
episodios	False
tiros	False
financiamiento	False
huellas	True
diámetro	False
adicional	False
tradiciones	True
cubre	False
componen	False
viajero	True
distancias	False
crudo	False
exposiciones	False
nostalgia	True
veían	False
parcialmente	False
usuario	True
novio	True
carnes	True
senadores	False
ministra	False
grabado	True
cerrados	False
repitió	False
símbolos	False
indicios	False
plantear	False
escolares	False
pisos	True
chicas	False
alrededores	False
suena	False
expuesto	False
rescate	False
crímenes	False
referéndum	True
volverá	False
sobrevivir	False
competir	False
radicales	True
logro	False
referido	False
confirma	False
informativos	False
lago	True
vídeo	True
obispos	False
casualidad	True
contratación	True
llegamos	False
alivio	True
avanza	False
disponibles	False
citados	False
pregunto	False
alerta	True
asesino	False
reside	False
manteniendo	False
oportuno	False
pensión	False
juicios	True
anuncios	False
participó	True
británicos	False
transferencia	True
residuos	True
prestar	False
titulado	False
sacerdotes	False
ideales	False
trascendencia	False
rechazó	False
mortalidad	True
obrero	True
depósitos	True
mostraba	False
apoyado	False
agregar	True
probabilidad	True
denunció	False
cristiano	False
fidelidad	True
simpatía	False
ausente	False
mero	False
flota	False
algodón	False
herramientas	True
abuso	False
enfrentamientos	False
compuesta	False
rodea	False
litro	True
puertos	True
considerados	True
obvio	False
esperaban	False
eficiencia	False
obstáculo	False
progresiva	False
estreno	False
vacía	True
atentados	False
rumor	False
liderazgo	True
destinada	False
creemos	False
metió	False
trámite	False
divisas	False
lanzamiento	False
lee	False
operativo	True
primo	False
sensaciones	False
apellido	False
observó	False
satélite	True
descubre	False
cruel	False
conjunta	False
modernización	True
ironía	False
bloqueo	False
ambientales	False
ofrecido	False
coordinador	True
aborto	True
acordó	False
sanción	True
muertes	False
daría	False
ideológica	False
tecnológico	False
ganancias	False
consumidor	False
puramente	False
ciego	False
deudas	True
nacionalismo	False
eventual	False
reagan	True
aclaró	False
grueso	False
disparos	False
acompañada	False
amable	False
continúan	False
ligero	True
desarrollan	False
mérito	False
norteamericanas	False
billones	False
brillo	True
perjuicio	False
supe	False
débiles	False
pañuelo	False
centenar	False
excesivamente	False
conducción	False
excelencia	False
produjeron	False
volúmenes	False
surgen	False
registros	False
históricas	False
series	True
prioridad	True
expulsión	True
cerebral	False
últimamente	False
señalando	False
retiro	False
desorden	True
exclamó	False
grasas	False
expresado	False
carencia	False
hígado	False
creando	False
músico	False
ejerce	False
acercamiento	True
bolívares	False
cc	False
previsiones	False
fijar	False
sometidos	False
botón	True
prohibición	True
bronce	False
normalidad	False
reveló	False
carbono	False
infinito	True
admitió	False
preocupaciones	False
ocurría	False
conductas	False
sustituir	True
transparente	True
preside	False
célula	False
bombas	False
magia	False
gestiones	False
suelos	False
aérea	False
declara	False
disputa	True
cúpula	False
significativa	False
destruir	False
utilizada	False
depósito	True
registró	False
consolidación	False
rivales	False
manda	False
sostener	False
inconsciente	False
ruidos	False
respecta	False
ubicado	True
universitario	False
japonés	True
emisiones	True
escuchó	False
poderosa	False
secundaria	False
tratamientos	False
rurales	False
ilegales	False
sencillamente	False
vivimos	False
denominación	False
domingos	False
creencias	False
verbal	False
obligada	False
visitante	True
permaneció	False
muchísimo	False
inmóvil	False
unidos	False
viajeros	False
cumplió	False
químicos	False
mover	True
riego	True
fino	True
chilena	False
preguntaba	False
conferencias	False
geográfica	False
fragmentos	False
trago	False
reúne	False
lanzar	True
núcleos	False
credibilidad	False
seda	False
aportar	False
chinos	False
playas	False
pretexto	False
firmeza	True
publicar	True
poética	True
secreta	True
onda	True
inocencia	False
gases	True
escasez	False
incluida	False
indicado	False
ritual	True
masculino	True
rehenes	False
gustado	False
contraria	False
tubo	False
coincidencia	True
interiores	False
atraviesa	False
educativa	False
afirman	False
das	False
colón	False
muscular	True
vaticano	False
continuamente	False
negativos	False
convento	False
confirmar	True
cerdo	True
sacado	True
esencialmente	False
atribuye	False
llanto	False
placas	False
aventuras	False
variación	True
desconfianza	True
investigador	True
salga	False
amantes	False
locos	False
desayuno	True
préstamos	False
colaborar	True
libremente	False
fijado	False
primas	False
seriamente	False
leyendo	False
violenta	False
antena	False
vitamina	True
aparecido	False
privilegio	True
maestra	False
licenciado	True
eterno	False
pertenecientes	False
iglesias	False
tolerancia	True
presentaba	False
evaluar	True
competición	True
índices	False
ácidos	True
validez	False
electrónico	True
placa	True
rusos	False
magistrados	False
promesas	False
localidades	False
corrida	True
novedades	False
ligera	False
estructural	False
fotógrafo	True
limita	False
convencional	True
bolsas	False
sugiere	False
marcador	True
rentabilidad	True
fruta	False
exigen	False
abordar	False
deportiva	True
digno	False
atracción	False
otorga	False
edades	False
existían	False
prohibido	True
configuración	True
madrileña	False
favorables	False
gama	False
órbita	True
marcada	False
gotas	False
extraños	False
logros	True
creatividad	True
jacques	False
fujimori	False
convierten	False
cosecha	True
considerablemente	False
pagado	True
despedida	False
percibir	False
chocolate	True
ola	False
detectar	False
superado	True
realismo	False
serios	False
volví	False
descansar	False
fumar	False
produzca	False
levantado	False
adhesión	True
compuestos	False
ubicación	True
inseguridad	True
presuntos	False
mm	False
cardenal	False
excelentes	True
salarial	False
controles	True
avanzado	False
ropas	False
desapareció	False
rechaza	False
aproximación	False
inclusive	False
penumbra	True
mortal	False
sumario	False
autobús	False
discusiones	False
trigo	True
aportaciones	False
refieren	False
pesado	True
aumentado	False
experimentado	True
causado	False
transparencia	True
tira	False
cenar	False
casco	True
reposo	False
majestad	False
costó	False
reconstrucción	False
concesiones	False
ondas	False
sagrado	False
corredores	False
testimonios	False
formato	True
separa	False
sucesivas	False
minoría	False
insuficiente	True
práctico	False
pantalón	False
elegidos	False
necesito	False
celda	False
residentes	True
urbanos	False
bloques	False
políticamente	False
pollo	False
fundador	False
recomendaciones	True
imposibilidad	True
retirar	False
marcar	True
cercanos	False
revisar	False
repertorio	False
repetición	True
enferma	False
departamentos	True
disparo	False
aprovechando	False
saliendo	False
contemporáneo	False
gala	False
rector	True
famosos	False
fábricas	False
filósofo	True
diariamente	False
excepciones	True
establecidos	False
gordo	False
concejales	False
llenar	True
afectadas	False
metas	True
modalidades	False
pilotos	False
trozos	False
peligrosa	False
exacta	True
terraza	False
ingresar	True
esperado	True
usado	False
escritorio	True
externos	True
prevenir	False
pico	True
jerusalén	True
cerámica	True
capilla	True
enamorado	False
desarrolló	False
bebida	True
pesadilla	False
suavemente	False
pasadas	False
pluma	True
comenzaba	False
duelo	False
pánico	False
delantero	False
observado	False
acudió	False
retórica	False
invisible	False
amarilla	False
indudable	False
quieras	False
ofrecía	False
salidas	False
minas	False
cirugía	True
describir	True
designación	False
oía	False
disminuye	False
rompió	False
estructurales	False
jerarquía	True
hogares	False
debates	False
representado	False
peces	True
ideológico	False
trampa	False
puse	False
levantarse	False
plazos	False
preparados	False
ciudadana	False
llevo	False
formaciones	False
recomienda	False
permanecen	False
protagonismo	False
desean	False
archivo	True
contando	False
sano	False
decisiva	False
legisladores	False
variedades	False
llevarse	False
aumentó	False
antigüedad	False
colega	False
limitada	True
elevar	True
ilusiones	False
transforma	False
partidario	False
vasca	False
llenos	False
disponible	False
justificación	True
méritos	False
fallecido	False
tomaba	False
específicamente	False
reiteró	False
dureza	False
futuros	False
defecto	False
esquemas	False
suponía	False
rebelión	False
estrecho	False
abría	False
corregir	False
prestaciones	False
transmitir	False
aldea	True
expedición	True
entraron	False
conveniencia	False
gasolina	True
hicimos	False
breves	False
aéreo	False
crecido	False
huella	False
pimienta	True
alcanzan	False
dictador	True
fantasmas	False
perejil	False
presidenta	False
realista	False
contestar	False
transformaciones	False
quedé	False
tecnológica	False
republicano	False
importación	False
avanzada	False
hallazgo	False
serenidad	False
ceder	False
vinculación	True
verme	False
analistas	True
billetes	False
reforzar	False
extradición	True
adopción	True
centenares	False
tarjetas	False
despierta	False
gobernantes	False
rehabilitación	False
modernidad	False
eterna	False
aplausos	True
católicos	False
áfrica	False
empleos	False
géneros	False
invertir	False
discriminación	True
maquinaria	False
estricto	False
firmó	False
introduce	False
pasaban	False
vuelos	False
griegos	False
vecina	False
semestre	True
legalidad	False
bello	True
ambición	True
colombiana	False
científicas	False
marqués	False
fatal	False
comunismo	False
peligros	False
frenar	True
movilización	False
tenis	True
jugado	False
mostraron	False
dirá	False
botellas	False
tome	False
tomada	False
haberlo	False
convenios	False
hablamos	False
reducida	False
parezca	False
gafas	True
lamentable	False
oscuros	False
insectos	False
apuntó	False
escuchaba	False
tienden	False
buscó	False
lleve	False
sargento	False
realidades	False
dirigía	False
reunir	False
instinto	True
escribía	False
universitaria	False
falda	False
querida	False
inscripción	True
manchas	True
envidia	True
restricciones	False
informativo	True
romano	False
demostración	True
volar	True
barrera	False
destacados	False
preferencia	True
poseer	True
demuestran	False
mención	False
creencia	True
gigante	True
justifica	False
dejarse	False
aguda	False
grano	False
abundantes	False
elemental	False
espectro	False
archivos	False
uñas	True
motores	False
ambientes	False
mencionados	False
producía	False
desaparece	False
averiguar	False
opina	False
profundos	False
revolucionaria	False
saltar	True
talleres	False
pulso	False
peticiones	False
sólida	False
adolescencia	True
complicaciones	False
generalizada	False
energías	False
experimental	False
caña	False
balanza	True
gallego	True
manipulación	True
constancia	False
coherente	True
portero	False
espectáculos	False
seriedad	False
magnífico	False
hallan	False
caminando	False
patente	True
condenados	False
tratarse	False
merced	False
digamos	False
mató	False
observadores	True
proponer	False
delicado	False
coger	False
ocupó	False
queja	False
corrió	False
típico	False
incorporar	False
óptica	False
producida	False
presidenciales	True
característico	False
cabellos	False
aporta	False
radica	False
jurisdicción	True
horizontal	True
pacífico	False
asociados	False
salvaje	False
quise	False
financiar	False
proporciones	True
captar	False
afectar	False
suelta	False
exacto	False
violento	True
considerando	False
obsesión	True
vestida	False
síntoma	False
supuso	False
palestinos	False
causó	False
construcciones	False
emitir	False
confrontación	True
servía	False
agujero	False
horrible	True
sucesor	True
relatos	False
rodilla	False
dulces	True
adecuadas	False
reportaje	False
cuidadosamente	False
interpretaciones	False
ajenos	False
menú	True
pescadores	False
divorcio	True
grandeza	False
mata	False
inconveniente	False
emprender	True
autos	False
tirar	True
tapa	False
árbitro	True
trozo	False
llamaban	False
despertó	False
pierden	False
tregua	False
traía	False
afectada	False
compañera	False
amigas	False
popularidad	True
surgido	False
perdieron	False
consultas	False
enseñanzas	False
urnas	False
ruinas	True
marcó	False
acostumbrado	False
sofá	False
barba	False
favorecer	False
tradicionalmente	False
fresca	False
celos	True
auge	False
utilizó	False
biografía	True
matices	False
independientemente	False
rusa	False
desprende	False
democráticos	False
retirado	True
paralelo	True
republicanos	False
andaluz	True
jugada	False
varía	False
restaurantes	False
afirmaciones	True
pájaro	False
luchas	True
comprometido	False
juegan	False
conjuntos	False
inminente	False
quejas	False
princesa	False
encuentre	False
apuesta	True
gobernante	True
rosas	False
establecen	False
contribuye	False
montar	False
pce	False
parado	False
íntimo	False
humilde	False
eficiente	True
trabajó	False
fibras	True
salvación	False
aprovechó	False
irregular	True
abiertamente	False
darme	False
vende	False
complicidad	False
amores	False
radiación	True
escenarios	False
vela	True
emplea	False
móvil	False
reunirse	False
digna	False
innumerables	False
judío	True
insistencia	False
sólido	True
constitucionales	False
pasaje	False
resistir	True
tour	True
calcula	False
crean	False
furia	False
pagan	False
amplios	False
damas	False
aprobar	False
comunitaria	False
bolívar	False
invitó	False
pautas	False
retratos	False
encargo	False
conscientes	False
maravilloso	True
valorar	False
refiero	False
electores	False
cese	False
productiva	False
abrigo	True
sed	True
íbamos	False
porvenir	False
vinos	False
caballeros	False
posturas	False
defensores	False
aplicado	False
experimentos	True
salinas	False
consejeros	False
reflexiones	False
diarias	False
dependen	False
trayecto	True
incorpora	False
rompe	False
poderosos	False
llenas	False
patrones	False
lanzado	False
facilita	True
participado	False
gritar	True
armando	False
descrito	False
ira	False
dejé	False
temores	False
productivo	True
escuchado	False
corteza	False
pacífica	False
parámetros	True
comprendido	False
preferido	True
sucia	True
prudencia	True
aparecieron	False
empresariales	False
adecuados	False
liberalismo	False
equivale	False
impulsar	False
maniobras	True
colocó	False
verduras	True
dramática	False
unanimidad	False
democráticas	False
casarse	False
mantequilla	False
sello	False
mercancías	False
héroes	False
precedente	False
pidieron	False
insistir	True
digas	False
caro	False
injusticia	True
precisar	False
saldo	True
participa	False
monumento	True
creciendo	False
intentaba	False
pistas	False
pechos	False
violentos	False
nube	False
ríe	False
químicas	False
dándole	False
regresa	True
economías	False
exclusivo	False
calcio	False
conocí	False
arzobispo	False
favorece	False
docente	True
venden	False
salían	False
interacción	False
carteles	False
provenientes	False
convocado	False
cargado	True
manifestaron	False
implicados	False
asistieron	False
historiador	False
túnel	True
restauración	True
muchachas	False
deseado	True
laboratorios	False
desconocidos	False
quitar	False
pretensión	False
parientes	False
papas	True
hábito	False
encargada	False
comercialización	True
llorando	False
dejaban	False
rutina	False
integridad	False
correctamente	False
continuaba	False
timbre	False
dedicados	False
dominar	True
mundiales	False
monopolio	True
diré	False
torno	False
secundarios	True
alusión	False
pc	True
competitividad	False
íntima	False
aprovechamiento	False
proviene	False
receptor	True
geográfico	False
señalaron	False
moléculas	True
rechazar	False
hallar	True
quieran	False
variantes	True
cambiando	False
coherencia	True
respirar	False
atacar	False
designado	False
mentalidad	False
impotencia	False
sanitario	False
sostenido	False
ubicada	False
anterioridad	False
escaños	False
plenitud	False
llegara	False
conjuntamente	False
transcurrido	False
capacidades	True
limitó	False
proposición	False
existido	False
sillas	False
asume	False
dependencias	False
consultar	False
llamamos	False
electrónica	False
especialidad	False
rtve	True
creció	False
falleció	False
video	True
esplendor	False
energético	False
proporcionar	False
manzana	True
cuotas	False
joyas	True
caía	False
previstas	False
narración	True
desconocida	False
comenzará	False
telefónicas	False
manual	True
rubia	False
juro	False
enlace	True
comentar	False
darles	False
marxista	False
moderado	False
vinieron	False
pronunció	False
préstamo	True
músculo	False
banderas	False
dotado	False
distingue	False
ptas	False
documental	False
adoptado	False
necesitamos	False
practicar	False
paisajes	True
merecen	False
altar	False
biológica	False
porción	True
exactitud	False
bonos	False
únicas	False
aumentando	False
estilos	False
dejo	False
progresivamente	False
apartamento	True
entendía	False
establecida	False
envío	True
destinadas	False
catedrático	False
sobra	False
iniciaron	False
narrativa	False
amplitud	True
duele	False
sospechas	False
rasgo	False
bola	True
potencias	False
metales	True
abarca	False
nobles	False
previstos	False
procedencia	False
ocupaba	False
ordenado	True
tratara	False
significaba	False
extinción	True
modernas	False
veras	False
colonias	False
adecuadamente	False
inconvenientes	False
fibra	True
recuerdan	False
sonar	False
sentimental	True
secundario	True
mueven	False
pasiones	False
teórica	False
buscado	True
trazado	False
frustración	False
compró	False
abren	False
parecida	False
ingenio	False
operar	True
talla	False
varón	False
times	False
máximos	False
responden	False
expone	False
sabiendo	False
pedirle	False
autónomas	False
atardecer	False
cortos	False
colocación	False
ejecutar	False
duque	False
advertencia	False
refería	False
escasas	False
trasladado	False
engaño	False
reflejos	False
dependiente	False
exploración	True
hondo	False
optimista	False
come	False
interminable	False
dedicación	False
consistía	False
campesino	False
saludo	True
agricultores	False
botas	False
excusa	True
asesinos	False
alcaldes	False
gota	False
corría	False
preparando	False
sonríe	False
lana	True
orillas	False
pozo	True
infantiles	True
buques	False
cuadrado	True
inversores	False
planetas	False
receptores	True
plomo	False
molesta	False
comarca	False
adelantó	False
visitó	False
debida	False
urbanas	True
falsas	False
impidió	False
hablo	False
encargados	False
cuidar	False
lástima	False
soviética	True
impulsos	False
víspera	False
dictamen	False
cometer	False
elegancia	False
legitimidad	True
transformar	True
cinematográfica	True
proximidad	True
lazos	False
sucesivos	False
futuras	False
gráfico	True
quiebra	False
brutal	False
risas	False
experimento	False
soviéticos	False
consiguiente	False
caen	False
suponen	False
relacionada	False
dados	True
rayo	False
ritmos	False
pelos	True
acierto	False
pedazos	False
deficiencias	False
legislatura	False
tortura	True
organiza	False
surgir	False
reivindicaciones	False
administrador	True
trámites	False
saint	False
hacerme	False
moción	False
doméstico	False
superficies	False
culo	False
serias	False
semilla	False
agraria	False
lejana	False
delicada	False
umbral	False
conformidad	True
abrazo	True
mencionada	False
traición	False
relevante	False
establecidas	False
nicaragüense	False
cobra	False
borracho	False
extensa	True
acompañar	False
mortales	False
estudiando	False
presta	False
cucharadita	False
psicológico	False
concede	False
sanitaria	False
exhibición	False
consistente	False
enseñar	True
planteó	False
franquismo	False
garantiza	False
efectividad	False
vivían	False
separados	True
lingüística	True
notablemente	False
reflejan	False
empezando	False
nuca	False
foco	False
pesada	False
quedaría	False
reestructuración	False
confirmado	True
granos	True
percibe	False
parada	True
exponer	True
conversión	True
hierba	False
falsos	False
cercanas	False
whisky	False
niebla	False
prometió	False
conforman	False
obviamente	False
superioridad	True
ordenar	True
supresión	True
terminal	True
idiomas	False
disponen	False
formó	False
inestabilidad	False
revelación	True
reunido	False
cómodo	False
sensibles	False
metáfora	False
dadas	False
prisioneros	False
ciclos	False
señoras	False
hablaban	False
secciones	False
adulto	True
psicológica	False
reclama	False
decoración	True
gustos	True
negado	False
natal	False
integrar	True
identificado	False
naves	False
ganando	False
holandés	True
aroma	True
recuperado	True
prudente	True
sabio	False
musulmanes	True
capacitación	False
denunciar	False
dirigidos	False
fármacos	False
dramático	False
organizadores	False
alcanzaron	False
absorción	True
trajes	False
decadencia	False
espejos	True
manifestantes	False
superficial	True
mineral	True
ediciones	True
solemne	True
vitales	False
intermedio	True
lavado	True
cemento	True
sana	False
cuerdas	False
querella	False
conductores	False
cotidiano	False
escribiendo	False
pronóstico	False
informativa	False
encanto	False
lentitud	False
cárceles	False
enseña	False
intervino	False
cogió	False
decirme	False
leyó	False
mágico	False
sutil	False
debidamente	False
inclusión	False
disponía	False
equivocado	False
oración	True
serbios	False
mantuvieron	False
cayeron	False
laterales	True
verdaderas	False
medellín	False
económicamente	False
intervienen	False
portugués	True
gen	False
catástrofe	True
entierro	False
usando	False
cocinar	True
eficaces	False
monstruo	False
tomarse	False
eleva	False
sostienen	False
fauna	True
causar	False
sorprende	False
convocar	False
aceptable	False
pasillos	False
elevación	True
fatiga	True
pureza	False
indicadores	False
presunta	False
negativas	False
bonita	False
sábanas	False
sigo	False
dirigirse	False
canta	False
importaba	False
lema	True
digital	True
medieval	False
asociado	False
situados	False
vínculos	False
hagas	False
dijera	False
tenor	False
flexibilidad	False
recogida	False
representaba	False
contribuido	False
oculto	True
apetito	False
adicionales	False
memorias	True
preparada	False
acogida	False
chaqueta	False
explican	False
medicamento	True
libras	False
comprado	False
colesterol	False
pa	False
certamen	False
pedazo	False
matado	False
pensamos	False
obrera	False
reunidos	False
anunciar	False
frágil	False
urbanización	True
relativos	False
factura	True
significativos	False
movía	False
eléctricas	False
harto	False
solicitudes	False
amnistía	False
confesión	True
conocían	False
cabecera	False
delirio	True
despliegue	False
ocurra	False
determinante	False
jurídicas	False
cargas	False
dependiendo	False
tocaba	False
vitaminas	True
mostrando	False
divertido	True
anécdota	False
volante	False
pido	False
teme	False
bacterias	True
subido	True
cumpleaños	True
táctica	False
insomnio	False
mete	False
penetración	True
nobleza	True
subasta	True
parciales	False
agrupación	True
abuelos	False
suministro	False
funcionan	False
vendido	True
lógicamente	False
pertenecía	False
verle	False
melancolía	True
lapso	False
cigarrillos	False
pondrá	False
recibirá	False
ferrocarril	False
huida	False
acordado	False
amplias	False
deportivas	False
definida	False
romanos	False
peruana	False
comunitario	False
piedad	False
subsecretario	False
localización	True
masculina	False
revolucionarios	False
mancha	False
automáticamente	False
asesinatos	False
registra	False
señalaba	False
pagó	False
recogido	False
clausura	False
clínico	False
instalar	False
buque	False
escoger	False
teléfonos	False
reconocen	False
almas	False
turístico	True
leña	False
heroína	False
campamento	True
típica	False
superó	False
recaudación	False
obtienen	False
retiró	False
partidas	False
mérida	False
acta	True
encargó	False
vinagre	False
elevadas	False
mármol	False
abusos	False
observador	True
infecciones	False
corrección	True
portada	True
cartón	False
inspector	False
creído	True
potente	True
cubiertos	False
teóricos	False
iluminación	True
medianoche	False
limpiar	True
venció	False
limitación	False
intuición	True
efectuado	False
húmedo	False
provocan	False
favorito	False
cd	True
sexualidad	True
dispuso	False
griega	False
catálogo	False
previsión	False
producciones	False
diputación	False
zedillo	False
líquidos	False
escapa	False
indignación	True
rebelde	True
mensuales	False
educativos	False
echado	False
olvida	False
prefieren	False
gustó	False
octavio	False
vacas	False
concluido	False
cintas	False
confesó	False
correspondía	False
abriendo	False
dejará	False
ala	True
desempeño	False
válido	False
empecé	False
recibía	False
bala	False
decidida	False
criminales	False
secas	False
curiosa	False
mundos	False
hongos	True
privilegios	False
afiliados	False
patronal	False
iría	False
rodean	False
permanentemente	False
piscina	False
domina	False
plumas	False
pintar	False
traduce	False
perfume	False
disolución	False
coraje	True
palos	False
abandona	False
conducido	False
mandos	False
extremadamente	False
expresamente	False
mejillas	True
trono	True
implacable	False
opera	True
arreglo	False
xv	False
pretensiones	False
obedece	False
conceptual	True
rincones	True
corbata	False
aislado	False
tardó	False
fortalecer	True
autonómico	False
exámenes	True
asistió	False
señas	False
muñeca	False
puentes	False
preguntado	False
movilidad	False
vejez	False
olímpicos	True
separar	True
generado	False
desfile	True
sistemática	False
significar	False
viajó	False
continuará	False
informática	True
sucio	True
anualmente	False
cotización	True
leonor	False
volviendo	False
rutas	False
prometido	False
ejecutivos	False
fomentar	False
deberes	True
pongo	False
desenlace	False
autobuses	False
meterse	False
ayudó	False
disciplinas	True
coyuntura	False
aislados	False
consuelo	False
corren	False
grabación	True
viera	False
provocando	False
lámpara	False
carecen	False
estatura	False
penetrar	False
misterioso	True
nacidos	False
examinar	False
predominio	False
atenas	False
editor	True
barato	True
cajón	True
viste	False
delincuencia	False
japoneses	False
radicalmente	False
distante	True
horarios	True
copias	True
producidos	False
alejado	True
fijos	False
turística	False
católico	False
militante	False
relevancia	True
sustancial	False
llevada	False
ajenas	False
nombrar	True
ordenamiento	False
fabricantes	False
aviraneta	False
cumpliendo	False
dirigidas	False
inversionistas	False
porcentajes	False
victorias	True
seminario	True
macho	False
baloncesto	True
consolidar	False
calificación	True
estadística	True
madrileños	True
ayudante	True
preferible	False
verso	False
seleccionar	False
temporadas	False
quitó	False
asumió	False
comprobado	False
seguimos	False
charla	True
ocio	False
olas	True
esculturas	False
poseía	False
trastorno	False
plantel	False
mañanas	False
objetiva	False
estimular	True
francesas	False
retirarse	False
repercusión	False
autonómicas	False
suspender	False
mecánico	True
condujo	False
dedicarse	False
detenerse	False
barroco	False
reflexionar	False
evitando	False
véase	False
procesamiento	False
llaves	False
israelíes	False
mantendrá	False
cortado	False
dormía	False
invita	True
dedican	False
envuelto	True
meramente	False
padece	False
aumentos	False
ingeniería	True
complemento	True
guerrillero	False
asciende	False
bancaria	False
muslos	False
extendió	False
tendido	False
vendedores	False
matemáticas	True
vinculados	False
hembra	False
manifiestan	False
proteína	False
romana	True
formalmente	False
afirmaba	False
penales	False
poblado	False
creativo	True
monseñor	False
adquirió	False
conspiración	True
aplicada	False
vulgar	True
jazz	True
invención	False
maleta	False
subvenciones	False
vinculado	True
pares	False
saldrá	False
concedido	True
suman	False
aficionado	False
diplomática	False
matanza	False
directos	False
defendió	False
perdía	False
ruina	False
insoportable	False
perdidos	False
comportamientos	False
atletas	False
pálido	False
mide	False
falla	False
generosidad	True
complutense	False
quedamos	False
primordial	False
orgulloso	True
ciega	False
requerimientos	False
consideramos	False
apropiado	False
sorpresas	False
veterano	False
maneja	False
rodaje	False
asegurado	False
advertido	False
oí	False
menciona	False
hegemonía	False
setiembre	False
sustituido	True
elementales	True
agudo	True
secos	True
herramienta	True
peruanos	False
emite	False
amar	False
peligrosos	False
concedió	False
artísticas	False
comprendió	False
parques	True
cometidos	False
imposición	False
cuidados	False
naturalidad	False
pata	False
océano	False
controla	False
cerradas	True
autónomo	False
inclinación	True
sentados	False
rechazado	False
grita	False
permitiría	False
fomento	False
relativas	False
culpables	False
acompañó	False
contesta	False
venezolana	False
permanecía	False
faena	False
repetía	False
monarca	False
jugaba	True
gráfica	False
feroz	True
valiente	False
conceder	False
reunieron	False
dispositivo	True
dialéctica	False
especializados	False
pulmones	True
fáciles	False
rastro	False
cobro	False
vencedor	False
portal	False
vacuna	True
devolver	False
utilizadas	False
oliva	False
velas	True
bomberos	False
receta	False
persigue	False
verás	False
dueña	True
ángeles	False
biológico	False
vencido	False
entrando	False
pretender	False
orina	False
terremoto	False
disgusto	False
abismo	False
televisor	True
excesos	False
patatas	False
puño	True
cruce	False
estético	False
monjas	False
lealtad	False
kilo	False
aspirantes	False
preferencias	True
puntas	True
significativas	False
mediación	True
mandar	False
mejoramiento	False
genético	False
demócrata	False
filial	True
lucía	False
mentiras	False
sueldos	False
leía	False
bruscamente	False
africanos	False
clínicas	False
sospechoso	False
comparten	False
analiza	False
fracción	True
paja	False
reclamar	False
consiguieron	False
elevados	False
fundada	False
mueren	False
recordando	False
servirá	False
colmo	False
logran	False
ayuntamientos	False
desconoce	False
regímenes	False
relevantes	False
tonos	False
eventos	True
constituyó	False
formulación	False
procurador	False
curvas	True
bondad	False
sirva	False
molestias	False
indicaron	False
asunción	False
ratos	True
llamo	False
extrañas	False
haití	False
haré	False
agrupaciones	False
sometida	False
barreras	True
contemporáneos	False
asco	False
casada	False
golfo	False
romántico	True
triunfos	False
rencor	False
preservar	False
reaccionar	False
mejoras	False
diseñado	False
anillo	False
interlocutor	True
mágica	False
previos	False
ordena	False
incendios	False
desnudos	False
comunitarios	False
patología	False
sonriente	False
presentados	False
identifica	False
anselmo	False
expresan	False
estratos	False
museos	False
coge	False
abrirse	False
publicados	False
terapéutica	False
introdujo	False
representada	False
sobrino	False
guerrero	True
seleccionado	False
prestado	False
bolsillos	False
cómoda	False
unen	False
divino	False
compensación	True
extendido	True
magnífica	True
japonesa	True
fantasías	False
prendas	False
asesores	False
ladrillos	False
externas	False
enfermera	False
reservados	False
contundente	False
comisaría	False
divina	False
movió	False
electorado	True
reservado	False
entienden	False
trágico	False
viaja	False
frentes	False
girar	True
susto	False
solicita	False
directivo	False
cambian	False
especializado	False
american	False
fabricar	False
mama	False
prolongado	True
sumar	True
ayudado	True
mediano	False
acudieron	False
tarifa	True
presentadas	False
actuó	True
desagradable	False
escuchando	False
hacerla	False
cristóbal	False
dejara	False
prejuicios	False
clic	False
redonda	False
darán	False
abstracción	True
crónicas	False
comparecencia	False
mediana	False
consistencia	False
defenderse	False
previsible	True
tremenda	False
arreglar	False
cubiertas	False
creadores	True
registraron	False
ánimos	False
formales	False
camilo	False
cia	False
belga	False
ente	False
legalmente	False
considero	False
opone	False
acercaba	False
volvería	False
comunicó	False
evidentes	False
calificado	True
vendrá	False
preguntarle	False
monasterio	False
solares	False
degradación	True
bordes	False
transformado	True
enseñó	False
motivación	True
salones	False
vestir	False
desarrollada	False
terceros	False
legislativas	False
cuna	False
destinos	False
indiferente	True
actuando	False
administrativas	False
apoyó	False
deportivos	False
bandeja	False
autora	False
bruto	False
anti	True
vigentes	False
dobles	False
permanentes	False
pobladores	False
trance	True
firmes	False
complejas	False
permitieron	False
decimos	False
porqué	False
latín	False
acompañan	False
injusto	False
sonriendo	False
federales	False
desarrollando	False
tremendo	False
compositores	False
bajando	False
generan	False
carros	False
acude	False
inevitablemente	False
denunciado	False
cielos	False
incorporado	False
expedientes	False
demonios	False
intérprete	False
encerrado	False
contrabando	False
infinita	False
metodología	False
partió	False
interpreta	False
explicado	True
ligado	True
prosa	True
levantamiento	False
probado	False
eternidad	False
iniciada	False
indiscutible	False
sales	False
criticó	False
bancario	False
dejen	False
institucionales	False
naval	False
creí	False
átomos	False
cantando	False
variar	False
aumentan	False
hable	False
discípulos	False
jurídicos	False
impunidad	True
haz	False
articulación	True
autonómica	False
recibiendo	False
influir	False
relevo	False
modesto	True
inmigración	False
mensual	True
facilidades	False
gorda	False
euforia	True
nicaragüenses	False
cantos	False
atravesar	False
comparte	False
trasladar	True
baleares	True
muelle	False
agresividad	False
picada	False
grabados	False
resultante	False
expectativa	False
citas	False
comparar	False
dorado	False
llamarse	False
provinciales	False
haberle	False
académicos	False
escritas	False
vacíos	False
coca	False
azulgrana	False
parados	False
ladrones	False
publicitario	False
atraer	True
amado	False
entenderse	False
conquistar	False
disponibilidad	True
devoción	False
aprecia	False
laberinto	False
puñado	False
che	False
extraer	True
explicaba	False
ramo	False
acorde	False
plástica	False
duerme	False
pasaporte	False
terminan	False
supervisión	True
llamaron	False
centavos	False
jugará	False
regalos	False
resuelve	False
cayendo	False
aspiración	True
inocentes	False
diplomáticos	False
manta	False
pinta	False
interrumpió	True
vínculo	False
contienda	False
medina	False
trenes	False
kilómetro	False
simbólico	False
exclusión	True
tazas	False
refiriéndose	False
narrador	False
mina	True
juzgados	False
demonio	False
recorte	False
vivas	False
dependerá	False
reconocida	False
aristóteles	False
conservan	False
montado	False
llevaría	False
mantenga	False
suaves	False
rotación	True
ordenación	True
clemente	False
enterado	False
instrumental	False
fríos	False
sopa	True
sucesivamente	False
procesión	False
acompañados	False
observando	False
químico	True
camas	False
cortas	False
vestuario	False
citadas	False
adoptada	False
cima	False
pertenecer	False
tiró	False
admirable	True
satélites	False
atento	True
ingenieros	False
calificar	True
chimenea	False
prolongada	False
aliado	False
complicada	False
armamento	False
descarga	True
aspira	False
recipiente	False
telecomunicaciones	True
apoyada	False
confía	False
totales	False
pintado	True
orlando	False
bolso	False
llegaría	False
rito	False
conlleva	False
grises	False
confirmación	False
ida	False
niñez	False
incluidas	False
convención	True
quisieron	False
venezolanos	True
sumo	False
demócratas	False
rentas	False
goma	False
anunciada	False
sarajevo	True
continental	False
exigía	False
calcular	True
extender	True
genial	False
armario	False
plantean	False
abrieron	False
religiones	False
lecturas	True
lograba	False
invento	False
formaban	False
representados	False
caridad	True
mitos	True
investiga	False
digan	False
márgenes	False
dolorosa	False
artificiales	False
combustibles	False
cenizas	False
soñar	False
compás	True
objetividad	False
significados	False
fotógrafos	False
sólidos	False
contará	False
negación	True
historiadores	False
ancha	False
desequilibrio	False
pabellón	False
origina	False
vacías	False
tristes	False
novelista	False
cruzó	False
inversa	False
etarras	False
reelección	False
variados	False
comodidad	False
antepasados	True
alquiler	False
entrañas	False
especializada	False
convirtieron	False
goza	False
prioridades	False
dividido	True
peseta	False
impresiones	False
camiseta	False
andan	False
publicitaria	False
positivas	False
supiera	False
alterar	False
verdades	True
multa	False
caracterizado	False
húmeda	False
templos	False
previas	False
consideradas	True
paralela	True
profundizar	False
marino	False
siniestro	False
violaciones	False
repetidas	False
añadido	False
podíamos	False
galerías	False
ritos	False
legislativo	True
uruguayo	True
psicosis	False
puestas	False
enterarse	False
apoyan	False
gatos	False
roque	False
razonamiento	True
pasaría	False
cruza	False
inquietudes	False
agregado	False
manzanas	False
aleja	False
temática	False
gozar	False
hilos	False
marxismo	False
inesperado	True
prefiero	False
disparar	False
descarta	False
ceremonias	False
bares	False
presidido	False
incorporarse	False
prestación	False
latinoamericana	False
actuado	False
llamamiento	False
recomendable	False
siembra	False
mares	False
realice	True
cuantía	False
estatutos	False
diferencial	False
venas	False
confundir	False
remate	False
lata	False
requisito	False
aguantar	False
cualidad	False
vistas	True
votantes	False
formular	False
organizó	False
arquitectos	False
replicó	False
presidida	False
imagino	False
dejarlo	False
termine	False
salí	False
mercancía	True
autopista	True
pesados	True
molde	False
apuntan	False
transmite	False
sonora	False
derrotado	True
trasladó	False
verte	False
conversar	False
jubilación	False
arias	False
queden	False
cantantes	False
construida	False
académica	False
pekín	False
desconcierto	False
prólogo	True
veamos	False
guardaba	False
procesado	False
damos	False
constituida	False
cráneo	False
defensiva	False
ratón	True
gravemente	False
espontánea	False
mejoría	False
cristianismo	False
energética	False
huelgas	False
inútiles	True
impiden	False
existan	False
perderse	False
tinta	True
unir	False
primitivo	False
relleno	False
disparó	False
párpados	False
apartados	False
comunicar	False
franja	True
gratuita	False
inesperada	False
nomás	False
desaparecidos	False
literalmente	False
auditorio	True
divide	False
sinceridad	True
ajedrez	True
terribles	False
gobernadores	False
embarazada	False
contenida	False
interviene	False
operan	False
físicamente	False
almirante	False
burla	False
registrados	False
consumir	False
caracterizan	False
tocando	False
imaginario	False
miserable	False
competente	False
generalizado	False
discreción	False
diferenciación	True
pianista	False
contribuyen	False
manifestar	False
respondía	False
terminaba	False
consigna	False
semejanza	False
adversario	False
contribuyó	False
cumpla	False
estricta	False
sábados	False
agonía	False
deportistas	False
proponen	False
matrícula	False
diplomáticas	False
recibida	False
subiendo	False
decidí	False
resoluciones	False
parroquia	False
ejércitos	False
coincidieron	False
latinoamericano	False
convencidos	False
pronunciado	False
extracción	True
proyecta	False
ocupada	False
severa	False
anotó	False
cascos	False
progresivo	False
curación	False
masivo	True
conducen	False
atractiva	False
manto	True
izquierdas	False
misiones	False
defensas	False
sujeta	False
prefirió	False
fijación	False
billete	False
especulación	False
feo	False
innovación	True
provecho	False
burocracia	False
gruesa	False
esferas	True
preferentemente	False
expulsado	False
retira	False
patrocinio	False
salvó	False
suscrito	False
delgado	True
irme	False
extenso	True
sustancialmente	False
bancarias	False
conservadora	False
encontrará	False
pasé	False
comprendo	False
compartido	True
valía	False
fundamentos	True
vuelvo	False
efectúa	False
ético	True
cercanías	False
expuso	False
pesa	False
segmento	True
seguirán	False
jamón	True
centra	False
helicóptero	False
operadores	False
marinos	True
lleguen	False
retroceso	True
espaciales	False
adelantado	False
matriz	True
caudal	False
llevamos	False
crecen	False
nocturno	True
múltiple	False
nuboso	False
yendo	False
determinan	False
gallina	True
mejorado	True
virtual	True
fundado	False
misiles	False
medallas	False
controlada	False
abstracto	True
primario	False
juveniles	False
sacrificios	False
suspendido	False
ordenadores	False
maravilla	False
códigos	True
intentaron	False
gritando	False
superación	True
esclavitud	False
construye	False
paulatinamente	False
besos	False
preguntarse	False
generoso	True
tramos	True
salvado	False
miraban	False
biblia	True
acabo	False
hicieran	False
riguroso	False
escudo	False
lecciones	True
insuficiencia	False
serrano	False
curar	False
recorre	False
reparación	True
intensamente	False
escondido	False
nieto	True
introducido	False
significó	False
bestia	False
concretar	False
expuestos	False
atiende	False
disimular	False
voluntariamente	False
paquetes	False
queriendo	False
multinacional	False
sodio	False
preocupante	False
situar	True
recomendación	True
administrativos	False
freno	False
consume	False
homicidio	False
pactos	False
ocurriendo	False
observan	False
hervir	False
potenciales	False
ingresó	False
heredero	False
francos	False
ponían	False
estudió	False
indemnización	False
séptimo	False
profesorado	False
indicaciones	True
sencillez	False
paradoja	False
ocurren	False
inventado	False
canela	False
excitación	False
compensar	False
frescos	False
homosexuales	False
estrés	True
adversarios	False
calorías	False
confiar	False
variadas	False
temía	False
protegido	True
afueras	False
diligencias	False
descender	True
romántica	False
envía	False
plana	False
hispano	False
lejanos	False
quehacer	False
álbum	False
celeste	False
borrar	False
temprana	False
aseguraba	False
relaciona	False
ganancia	True
involucrados	False
pasamos	False
válida	False
arranque	False
senos	False
bailes	False
cómplice	False
filósofos	True
impuesta	False
deseable	True
legítimo	False
almacén	True
inquietante	False
controlado	True
feto	False
saltó	False
acompañaba	False
situarse	False
industrialización	True
decida	False
llenó	False
maravillosa	False
enmienda	False
voluntarios	False
captación	True
atenta	False
aportes	False
esperamos	False
efectuó	False
ordinario	True
acera	False
visibles	False
melodía	False
narcotraficantes	False
navegación	False
variante	False
concepciones	False
reúnen	False
rubio	True
robado	False
productivas	False
iniciación	False
idéntico	False
optar	True
pez	True
brigada	False
potable	False
sonreír	False
camina	False
califica	False
inauguró	False
adquieren	False
precauciones	True
resolvió	False
pegado	True
gestación	False
verán	False
variado	False
moderada	False
toreo	False
visiones	False
empleada	False
rodeada	False
incapaces	False
presuntamente	False
fianza	False
centenario	False
ilustre	False
fundó	False
monumental	True
dotación	False
partiendo	False
consecución	False
doctora	False
reparar	False
bebe	False
traen	False
ecuación	False
acabaron	False
colaborador	True
mitin	False
usados	True
cortinas	True
mineros	False
esconde	False
pedí	False
detectado	False
maldito	False
aseguraron	False
asociada	False
producidas	False
dedicadas	False
tomo	False
terminaron	False
rescatar	False
tomates	False
desesperado	True
espíritus	False
conexiones	False
proporcional	True
decirte	False
absurda	False
procuraduría	False
dudar	True
agotado	False
otorgar	False
monetario	False
desigual	False
cuaderno	False
telón	False
procesados	False
pasear	False
temporales	False
definen	False
sospechar	False
mono	False
luchando	False
temo	False
redujo	False
estratégico	False
dirigen	False
cirujano	False
yemas	True
vitalidad	True
vicio	False
estratégica	False
doloroso	False
sucedía	False
primitiva	False
valioso	False
utopía	False
poético	True
ofreciendo	False
puros	False
calientes	False
descubrimientos	False
uniformes	True
mutuamente	False
elegida	False
desempeñar	False
dijiste	False
precisas	False
reconstruir	False
tacto	True
incorporó	False
enormemente	False
creyendo	False
cortó	False
estrechamente	False
reconciliación	False
dispersión	False
veneno	True
vertiente	False
recogen	False
colocan	False
faltas	False
electrones	True
insólito	False
producirá	False
vengo	False
láminas	False
proceden	False
temblor	False
protocolo	True
cinturón	False
alianzas	False
confiesa	False
adaptarse	True
higiene	True
someterse	False
helms	False
palinuro	False
triángulo	True
réplica	False
criado	True
aluminio	False
perteneciente	False
invertido	True
sanitarios	False
filosófica	True
confuso	True
bata	False
américas	False
revelan	False
enteramente	False
unánime	False
levemente	False
legado	False
acuden	False
sitúan	False
compasión	True
temer	False
cruzado	False
permanecido	False
misteriosa	False
muertas	False
aviación	True
trapo	False
composiciones	False
hierbas	False
cortesía	True
rallado	False
nacen	False
coma	True
convencimiento	False
recesión	False
medicinas	True
compatriotas	False
voluntaria	False
cuadra	False
alcoholismo	False
violín	True
camarero	True
surgieron	False
futbolista	True
ejes	False
quedo	False
almacenes	False
dedicar	False
textura	False
reclamo	False
silueta	False
ayudan	False
aceptada	False
anciana	False
ecológico	False
literarios	False
nacho	False
sigan	False
explotar	False
futbolistas	False
batallas	False
especialización	True
asumido	False
convirtiendo	False
racionalidad	False
metálico	False
bastón	False
tecnológicos	False
frontal	True
vendedor	True
ratas	False
depresivo	True
depresiones	False
educativas	False
renacimiento	False
soberbia	False
despertado	False
entrenamientos	False
retención	True
crueldad	False
sufrieron	False
subraya	False
tomadas	False
salimos	False
valles	False
diálogos	False
recto	False
convergencia	True
divisa	False
auxilio	False
optó	False
gritaba	False
saliva	False
proliferación	False
prever	False
vean	False
facciones	False
divisiones	False
olla	False
nómina	False
seguidos	False
hormonas	True
convocó	False
hornos	False
idiota	False
levantaba	False
liquidación	False
pasajes	True
rápidos	False
lienzo	False
secuestrado	False
alcanzaba	False
apreciación	True
manga	True
comentado	False
largamente	False
enmiendas	True
semanario	False
creían	False
interesaba	False
revelado	False
desacuerdo	False
flexible	True
atrevió	False
libra	False
balas	True
dejamos	False
correlación	True
marchó	False
serpiente	True
ligada	False
limitar	False
mencionadas	False
interesan	False
fotográfica	False
ministerial	False
prosperidad	True
excepcionales	False
escape	False
enviados	False
discreto	False
discípulo	True
pascual	False
cereales	False
silenciosa	False
sonoro	True
crucial	False
fijó	False
repercusiones	False
sendero	True
aparecían	False
nudo	False
mejilla	False
canadiense	False
estallar	False
erosión	True
obtuvieron	False
emisor	False
aceptan	False
cineasta	False
anunciaba	False
encabeza	False
cauce	False
lavar	True
obligatorio	False
eligió	False
flamenco	True
rebaja	False
descontento	False
ricas	False
tope	False
polo	False
considere	False
economista	True
ocupados	False
preocuparse	False
coincidir	False
niegan	False
circuitos	False
restante	False
demora	True
indirectamente	False
despejado	False
simpático	False
recetas	True
oyentes	True
licencias	False
dorada	False
cueva	True
molesto	True
africano	False
encierra	False
concentraciones	False
cinematográfico	True
pronunciar	False
curiosos	False
quieto	True
velada	False
inspectores	False
unirse	True
hidrógeno	True
amargo	True
terrestres	False
encender	False
apoyos	False
dinámico	False
administrar	True
convocada	False
geometría	True
secuencias	False
montes	False
soltó	False
regulares	False
progresista	False
corrido	False
narices	False
mostrador	False
minorías	False
recuento	False
tropical	True
acuerdas	False
padecen	False
agresiones	False
prostitución	False
cuñado	False
aurora	True
recogió	False
gradual	True
administraciones	False
aclara	False
cogido	False
tumores	False
liberalización	False
fragmento	True
estalló	False
titulada	False
jacinto	False
protestar	False
critica	False
brisa	False
amarillas	False
focos	False
custodia	False
mutuo	False
razas	False
cohesión	False
quedarán	False
candidaturas	False
obtenida	False
durar	False
mate	False
extremidades	True
preocupes	False
faltó	False
cargar	False
fósiles	True
regula	False
cerco	False
decepción	False
insultos	False
cesar	False
prosiguió	False
convencionales	False
sandinistas	False
espectaculares	False
tibia	False
legislativa	True
auténticos	True
liberar	False
mayoritario	False
nocturna	True
combinaciones	False
encendido	False
rendir	False
enteros	False
maldita	False
nativos	False
precioso	False
telas	False
eléctricos	False
desarrollarse	False
contratar	False
brasileña	False
alejarse	True
indicación	True
guardan	False
sonó	False
viabilidad	False
sugerencias	False
construyó	False
discrepancias	False
socialmente	False
palmas	True
lineal	True
explosivos	False
combates	False
vísperas	False
provienen	False
aplican	False
sexta	False
agradecimiento	False
evidencias	False
móviles	False
ventanilla	False
repetido	False
subrayar	False
cabía	False
movido	False
legislador	True
orientales	False
formidable	False
descendientes	False
musculares	True
hermosas	False
dionisio	False
helado	False
renovar	True
vayas	False
comercios	False
tomas	False
escogido	False
vocales	False
espuma	False
aplicarse	False
vendría	False
bando	False
monumentos	False
precisos	False
seleccionados	False
aguja	True
batería	False
contribuyentes	False
hallazgos	False
abastecimiento	False
gigantesco	False
dispuestas	False
visuales	True
codo	False
afortunadamente	False
terminada	True
formados	False
precipitaciones	True
torpe	False
avanzando	False
enteras	False
talante	False
recibo	True
inserción	True
rodar	False
marcharse	True
mutua	False
interpretado	False
funda	False
toreros	True
llamando	False
autorizado	True
incómodo	True
lucrecia	False
derivadas	False
mudo	False
diosa	False
fugaz	True
suavidad	False
fracasado	False
activamente	False
rige	False
vitoria	False
arcos	False
suizo	True
despido	True
prescindir	False
botones	False
sugirió	False
ofrecieron	False
ignorar	True
dominación	False
designar	False
mozo	False
implicaciones	True
enfrentan	False
francamente	False
determinó	False
amorosa	False
rentable	False
resaltar	False
organizados	False
preparan	False
inmediatos	False
anunciaron	False
calibre	False
sumó	False
originalidad	True
lucidez	False
cocido	False
vestíbulo	False
ezequiel	False
históricamente	False
estables	False
finas	False
guapa	False
pipa	False
republicana	False
bajado	True
protector	True
cejas	False
sentencias	False
rebeldía	True
desesperada	False
parecidos	False
ignora	False
cortina	False
cubren	False
comprobó	False
opositores	False
interrogantes	False
colecciones	False
resta	False
reproducir	False
suceden	False
tirado	False
agitación	False
amargura	False
devolución	True
sostenía	False
iniciará	False
subía	False
envergadura	False
mandado	False
vértigo	False
ángulos	False
idéntica	False
instaló	False
recuperó	False
corridas	False
alzó	False
murmuró	False
arranca	False
estallido	False
lío	False
certificado	False
disminuido	False
extra	False
celebran	False
vinculadas	False
severo	False
exigió	True
enfermería	True
asoma	False
comerciante	False
castellana	False
creativa	False
prolongación	True
encuentren	False
especializadas	False
domésticos	False
definió	False
membrana	True
liberado	False
excursión	False
concentrado	True
trataron	False
doctores	False
faltaban	False
conducía	False
ascensor	True
aconsejable	False
cal	False
ponerle	False
capricho	True
quedara	False
asientos	False
cátedra	False
dispositivos	False
vería	False
acostumbrados	False
dinamismo	False
contemplación	False
sereno	True
interesada	False
acumulado	True
dominantes	False
falsedad	True
movilizaciones	False
verificar	False
honestidad	False
prenda	False
conformación	False
usaba	False
cautela	False
voluntario	True
simbólica	False
dormida	False
encarga	False
compone	False
chorro	True
descomposición	True
lomo	False
viceversa	False
pecados	False
concha	False
andaluza	False
callado	False
camioneta	True
agresivo	True
trágica	False
contrarios	False
inventar	False
mapas	False
iniciarse	False
prisionero	True
pasara	False
auxiliar	True
abanico	False
generosa	False
atractivos	False
ave	True
vocero	False
biología	False
electo	True
salvajes	False
formaron	False
escándalos	False
nutrición	True
carcajada	False
directas	True
polémico	False
molécula	False
milagros	False
despidió	False
opresión	False
imaginaba	False
revelar	True
comporta	False
defendido	False
cantabria	False
artísticos	False
filosófico	False
instalada	False
superan	False
curas	True
sincero	True
inmediaciones	False
difunto	False
velo	False
encierro	False
millas	False
linda	False
separan	False
volverse	False
reinado	False
incumplimiento	False
oficios	False
leves	False
ideológicas	False
mixta	False
nutrientes	True
eguren	False
transferencias	False
recupera	False
realizador	False
paradigma	False
contenía	False
ganan	False
saludable	True
puntualizó	False
consorcio	False
aislada	False
diversión	False
refuerzo	False
fortalecimiento	False
saltos	True
jaula	False
contratado	False
mezclar	False
silencioso	True
rendimientos	True
párrafos	False
deficiencia	False
tele	False
helicópteros	False
saludar	False
sagrada	True
incipiente	False
reivindicación	False
arrastra	False
dominado	True
cañón	False
favoritos	False
franquista	False
convertida	True
pastor	True
patricio	False
productivos	False
fallas	False
inicios	False
contraloría	False
difundir	True
sequía	True
etiqueta	True
adelantar	False
resiste	True
show	False
metabolismo	True
extraordinariamente	False
mataron	False
afectó	True
campanas	False
ambigüedad	False
adoptó	False
registrar	False
soberano	False
comiendo	False
concebir	False
opuesta	False
bulto	False
ideologías	False
kid	False
convierta	False
situó	False
súbita	False
irreversible	True
influye	True
promotores	False
emitió	False
brinda	False
fray	False
atributos	True
vendió	False
misterios	False
arterial	False
aprendió	False
sandinista	False
diversa	False
petrolera	False
sufriendo	False
tribu	False
cónsul	False
contracción	False
rigidez	False
equivalentes	False
alfombra	True
sartén	False
itinerario	True
obligan	False
adjunto	False
protege	False
redondo	True
amistades	False
licitación	False
arrancó	False
banqueros	False
sirvieron	False
desigualdad	True
reconocidos	False
tomará	False
aliviar	False
editoriales	False
indudablemente	False
adjudicación	False
novios	False
atendiendo	False
guantes	True
funcionales	False
larra	False
compadre	False
casó	False
asistente	False
asistido	False
