word	group_known
años	False
vida	True
país	True
año	True
mundo	True
presidente	True
caso	False
forma	False
millones	False
hombre	True
nacional	True
política	True
partido	False
grupo	True
frente	True
personas	True
mujer	True
ciudad	True
social	True
sistema	True
historia	False
punto	True
noche	True
situación	True
tipo	True
agua	True
países	False
ley	True
proceso	False
mano	True
cambio	True
importante	True
realidad	True
desarrollo	True
sociedad	True
centro	True
número	True
cuerpo	True
gente	True
siglo	True
guerra	True
obra	True
padre	True
ojos	True
don	False
pueblo	True
muerte	True
público	False
problemas	True
mañana	True
madre	True
nombre	True
meses	False
hombres	False
derecho	True
problema	False
cabeza	True
hora	True
ministro	True
información	True
señor	False
mujeres	False
tierra	True
director	True
pesetas	False
manos	True
llegar	False
cosa	False
familia	True
equipo	True
casos	False
falta	False
seguridad	True
nivel	True
voz	True
iba	False
semana	True
mayoría	True
español	True
luz	True
orden	False
político	True
proyecto	True
mercado	True
internacional	False
paso	False
empresa	True
policía	True
palabras	True
fuerza	True
puesto	True
puerta	True
comisión	True
programa	True
española	False
real	True
único	True
acción	True
libro	True
interior	True
condiciones	True
calle	True
obras	False
capital	True
música	True
dios	True
fondo	False
persona	True
dinero	True
hijo	True
zona	True
tema	True
razón	True
camino	True
papel	True
vista	True
hablar	True
presencia	True
libertad	True
especial	False
actual	True
relaciones	False
servicio	False
campo	True
relación	True
minutos	False
medios	True
producción	True
movimiento	True
idea	True
julio	True
miembros	True
interés	True
alto	False
principio	False
dirección	True
arte	True
cultura	True
empresas	True
hacía	False
visto	False
puntos	False
mes	True
sector	False
población	True
difícil	False
fuerzas	False
grupos	False
imagen	True
figura	True
futuro	False
militar	True
servicios	True
espacio	True
posibilidad	False
niños	False
económica	False
economía	True
personal	True
jefe	True
carácter	True
organización	True
central	True
actividad	False
aire	True
banco	False
prensa	False
popular	True
necesario	True
justicia	True
joven	True
comunidad	True
edad	True
políticos	False
efecto	True
pública	False
cara	True
crisis	True
decisión	True
necesidad	True
duda	True
capacidad	True
estudio	True
dólares	False
ministerio	True
defensa	True
mundial	False
televisión	True
serie	True
quiero	False
sociales	True
datos	True
base	False
investigación	True
época	False
control	True
queda	False
hijos	True
pasar	True
civil	False
salud	True
paz	True
juego	True
presente	True
niño	True
resultados	True
educación	True
derechos	True
resultado	True
conjunto	True
recursos	True
atención	True
allá	False
izquierda	True
partidos	False
importancia	True
contrario	True
menor	False
pasa	False
resto	False
gracias	True
administración	True
palabra	True
seguir	False
salir	True
fuerte	False
causa	True
calidad	True
medida	True
elecciones	False
secretario	True
silencio	True
comunicación	True
libre	True
fuentes	True
parecía	False
oficial	True
cine	True
mesa	True
cabo	False
españoles	False
naturaleza	False
apoyo	True
importantes	False
común	False
económico	False
principal	False
sol	True
decía	False
energía	True
mar	True
clase	False
dejar	True
especialmente	False
experiencia	True
cantidad	True
jóvenes	True
objeto	True
rey	True
opinión	True
función	True
estudios	False
superior	True
posición	True
única	False
reunión	True
color	True
respuesta	True
trabajadores	False
radio	True
viejo	True
alta	False
sangre	True
evitar	False
elementos	True
resulta	False
partes	False
pensar	True
suelo	True
lucha	True
actividades	True
origen	False
ejército	True
boca	True
medidas	False
cargo	True
américa	True
tomar	False
autoridades	False
autor	True
hechos	False
precisamente	False
pie	True
existencia	True
ayuda	True
productos	True
régimen	False
objetivo	False
teatro	True
políticas	True
sabía	False
línea	True
quería	False
crecimiento	True
acciones	True
encuentro	False
muestra	False
natural	True
compañía	False
derecha	False
carta	True
seguro	False
momentos	True
amigos	False
artículo	True
acto	False
doctor	True
amigo	True
viene	False
formas	True
consecuencia	True
región	True
cuarto	True
ve	False
campaña	True
diario	True
norte	True
metros	False
argentina	True
deja	True
éxito	False
ambiente	True
tiempos	False
actitud	True
escuela	True
especie	False
participación	True
domingo	True
formación	False
finalmente	False
permite	False
blanco	False
marcha	True
baja	False
río	True
principales	False
espera	False
mitad	False
juez	True
sur	False
entrada	True
grande	True
cuadro	False
vivir	False
miedo	True
cambios	False
enfermedad	True
valores	True
llegado	True
mayo	True
estructura	True
negro	True
acerca	False
mira	True
ideas	True
expresión	True
santa	True
construcción	True
análisis	True
peso	True
padres	True
fácil	False
conocimiento	True
pequeño	True
tratamiento	True
democracia	True
materia	True
humanos	True
corazón	True
fecha	True
mayores	True
cuestión	False
unidad	True
diferencia	True
plazo	True
vino	True
período	True
llega	False
texto	True
efectos	False
señora	True
práctica	True
volvió	True
informe	True
puerto	True
cultural	True
socialista	True
oposición	False
carrera	False
tribunal	True
industria	True
pese	False
médico	True
volver	True
asunto	False
mirada	True
exterior	True
llamado	False
favor	True
produce	True
libros	True
enero	True
conciencia	True
atrás	False
mantener	True
cámara	True
modelo	True
electoral	True
sectores	False
diciembre	True
fuego	False
distintos	False
intereses	True
salida	False
técnica	True
ocasión	False
fiscal	True
mejores	False
comercio	True
creación	True
solución	True
vuelta	False
entrar	True
suerte	False
razones	False
aumento	True
pasó	False
principios	True
militares	False
sala	True
humano	True
ocasiones	False
revolución	True
reforma	True
precio	True
características	True
voluntad	True
aspectos	False
recuerdo	False
puso	False
capaz	True
juicio	True
encontrar	False
película	True
programas	False
zonas	False
hija	True
asimismo	False
memoria	True
prueba	True
primeras	True
junio	True
sueño	True
contenido	True
operación	False
título	True
octubre	True
cama	True
toma	False
fútbol	True
posibilidades	False
esfuerzo	True
asociación	False
temas	False
particular	False
producto	True
aspecto	True
vio	False
muerto	True
marco	True
local	True
etapa	True
pequeña	False
corte	False
profesional	True
violencia	True
armas	True
dolor	True
pone	False
ciencia	True
precios	False
presenta	False
llama	True
centros	True
pregunta	True
generales	True
jamás	False
visita	False
victoria	True
suficiente	True
semanas	False
vía	True
riesgo	True
propuesta	False
vuelve	False
busca	True
consumo	True
aparece	False
área	True
siguientes	False
grado	True
tipos	False
encuentran	False
estilo	True
concepto	True
instituciones	True
cielo	True
carne	True
instituto	True
larga	False
material	True
perdido	True
comenzó	False
deseo	True
hermano	True
lenguaje	True
dije	False
cree	False
líder	True
oro	True
humana	True
abril	True
términos	False
buscar	True
simple	True
podido	False
imposible	True
marzo	True
ido	False
conocido	False
septiembre	True
rostro	False
anteriores	False
curso	True
destino	True
nacionales	False
nación	True
motivo	True
piel	True
departamento	True
grave	True
francés	True
condición	True
asuntos	False
preguntó	False
trabajos	False
tercer	False
terreno	True
obtener	True
club	True
responsabilidad	True
hospital	True
ejecutivo	True
comité	True
capítulo	True
noviembre	True
palacio	True
escrito	False
daba	False
doña	False
digo	False
movimientos	False
término	True
máximo	False
propiedad	True
lengua	False
niveles	True
industrial	True
organismo	True
doble	False
ocurre	False
proyectos	True
distancia	True
contacto	True
ejercicio	True
peligro	True
calles	False
oportunidad	True
leyes	True
novela	True
significa	False
ciudades	False
funciones	False
animales	False
presión	True
altura	True
gusta	False
selección	True
gusto	False
teoría	True
isla	True
espíritu	True
lunes	True
pensamiento	True
alma	True
imágenes	True
aplicación	True
verano	True
esperar	True
paciente	True
agosto	False
lograr	True
dejado	False
guardia	False
exposición	True
lugares	False
hotel	True
par	True
crear	True
lista	True
factores	True
sistemas	False
pueblos	False
tratado	True
ciudadanos	False
declaraciones	False
sitio	True
realmente	False
pies	True
dirigentes	False
demanda	True
directamente	False
maestro	True
viernes	True
clara	False
confianza	False
brazos	True
funcionarios	False
sale	True
llamada	True
marido	True
frecuencia	False
moral	True
pequeños	True
diputados	False
totalmente	False
visión	True
intervención	True
normal	True
pobre	True
supone	False
municipal	True
finales	False
kilómetros	False
jugadores	False
objetivos	True
perder	False
esposa	True
fuente	True
enorme	True
discurso	True
pena	True
judicial	False
acceso	True
necesidades	True
protección	True
procesos	False
circunstancias	False
entender	True
conflicto	True
pesos	True
presidencia	False
febrero	True
oficiales	False
páginas	True
representantes	False
temporada	False
públicas	False
pacientes	True
flores	True
evolución	True
técnico	False
pan	True
mala	True
salió	True
red	True
fundamental	True
superficie	False
escena	True
golpe	True
profesionales	False
alcalde	True
teléfono	True
café	True
propósito	True
candidato	True
gesto	True
líneas	False
gestión	True
contar	False
venta	True
ofrece	False
física	True
abajo	False
coche	True
diferencias	False
inversión	True
diálogo	True
calor	True
mamá	False
tarea	True
clases	False
constituye	False
personajes	True
casas	False
territorio	True
responsable	True
llevó	False
documento	True
cambiar	True
europeo	True
tono	True
internacionales	False
aguas	False
europea	False
pintura	True
intención	True
establecer	True
alcanzar	False
públicos	False
respeto	False
frío	True
influencia	True
pasos	False
literatura	True
fenómeno	True
nombres	False
asamblea	True
autores	False
ayuntamiento	True
comercial	True
dando	False
ritmo	True
pruebas	False
fines	False
estudiantes	True
necesita	True
audiencia	True
locales	True
técnicas	False
crítica	True
señala	False
conducta	True
ganar	False
afirma	False
actualidad	True
familiar	True
normas	True
triunfo	True
cumplir	True
empezó	False
leche	True
sábado	True
blanca	False
cabe	False
representación	True
labor	True
equipos	False
refiere	False
sensación	True
tradición	True
jugar	False
muertos	True
compañeros	True
sujeto	False
periódico	True
parecer	False
mantiene	False
competencia	True
profesor	True
alimentos	True
consecuencias	True
declaración	True
objetos	False
vecinos	True
pagar	True
mensaje	True
debate	True
iban	False
comer	True
referencia	False
quieren	False
hacerse	False
vi	False
declaró	False
pidió	False
definitiva	False
edificio	True
jornada	False
dicha	True
fondos	True
médicos	False
dificultades	True
simplemente	True
actos	False
aceite	True
vive	False
fig	False
plano	True
plantas	True
justo	False
posibles	True
representa	True
noticia	True
franco	True
prácticamente	False
versión	True
evidente	True
actuación	False
quedado	False
inmediato	False
miembro	True
tratar	False
suele	False
recién	False
niña	True
caer	True
ámbito	False
habitantes	False
llevaba	False
materiales	False
ausencia	True
fiesta	True
colegio	True
naciones	False
instante	True
brazo	True
áreas	False
corresponde	False
económicos	True
situaciones	True
escribir	True
llegada	True
ven	False
recibió	False
madera	True
federal	True
pleno	False
haga	False
ministros	False
pérdida	True
nota	True
museo	True
fase	False
provincia	True
velocidad	True
veía	False
institución	True
puertas	True
agentes	False
dispuesto	False
recibir	False
tamaño	True
tierras	True
transporte	True
próxima	False
decidió	False
habitación	True
tío	True
revista	True
explica	False
comunidades	False
autoridad	True
socialistas	False
década	False
personaje	True
escenario	True
corriente	True
mínimo	False
independencia	True
abierto	False
histórico	False
viento	True
escritor	True
presupuesto	True
convertido	True
organizaciones	True
tendencia	True
votos	False
secreto	True
acaba	False
anunció	False
produjo	True
operaciones	False
probablemente	False
familiares	False
alumnos	True
pelo	True
periodistas	False
conoce	False
esperanza	True
martes	True
vieja	False
antiguo	False
quiso	False
familias	False
posteriormente	False
reciente	True
división	False
cocina	True
pretende	False
entrevista	True
siguen	False
igualmente	False
piernas	False
reina	False
planta	False
identidad	False
aparte	False
completo	True
comienza	False
hacienda	True
comida	True
rato	False
alemán	True
presentó	False
naturales	False
verde	True
error	True
especies	False
barrio	True
piso	True
volumen	True
hojas	True
piensa	False
recordar	True
comportamiento	True
disposición	True
estrategia	True
necesaria	False
funcionamiento	True
compromiso	True
juegos	True
reacción	True
económicas	False
aparición	False
ingresos	True
abogado	True
oficina	True
consiste	False
parecen	False
cuidado	True
sentía	False
colores	True
soldados	False
recibido	False
elección	True
cárcel	False
pago	True
pequeñas	True
decisiones	True
piedra	True
incremento	False
liga	False
entra	False
distribución	True
suma	True
edición	True
trataba	False
procedimiento	False
iniciativa	True
logró	True
darle	False
poeta	True
cadena	True
sede	True
plata	True
jueves	True
utilizar	True
portavoz	True
similar	True
querido	True
ventana	True
quieres	False
deuda	True
regional	True
animal	True
canal	True
norteamericano	True
continuación	False
medicina	True
inglés	True
venido	False
privada	True
personalidad	True
federación	True
bienes	False
altos	False
parque	True
ataque	True
fe	False
abierta	True
preciso	False
tradicional	True
investigaciones	False
regiones	False
entidad	True
directa	True
enfermedades	False
firma	False
siglos	False
hermanos	False
seres	True
responsables	False
filosofía	True
sirve	False
temperatura	True
presentar	True
ropa	True
elemento	True
sombra	True
alianza	True
decidido	True
carga	True
extranjeros	False
santo	True
luna	True
causas	True
empresarios	False
figuras	False
permanente	True
método	True
huelga	True
marca	True
leer	False
oferta	True
margen	True
presentación	True
azul	True
noticias	False
acaso	True
acuerdos	False
búsqueda	True
tomó	False
constitucional	False
concepción	True
gobernador	True
aparecen	False
juntos	True
cuello	True
puestos	False
pobres	False
constante	True
bancos	False
resolver	True
quedan	False
comienzo	True
labios	True
contrato	True
hermana	True
abrir	False
logrado	False
matrimonio	True
frase	True
llegaron	False
hará	True
importa	False
morir	True
sorpresa	False
documentos	True
caja	True
gastos	True
generalmente	False
extremo	False
caída	True
pareja	False
bolsa	False
encontraba	False
masa	False
previsto	False
titular	False
clave	False
dormir	True
reducción	False
culpa	True
producido	False
menores	False
preocupación	True
terminar	True
miércoles	True
considerar	True
esfuerzos	False
preguntas	True
espectáculo	True
colaboración	True
mente	True
crédito	True
original	True
bases	False
feliz	True
democrática	True
hablando	False
negocio	True
llevado	False
oído	True
diputado	True
decreto	True
europeos	False
tecnología	True
plena	False
cartas	True
películas	True
detalles	True
sentir	True
sacar	False
dirigente	True
veo	False
graves	False
únicamente	False
vas	False
entrega	True
miró	False
corto	False
artista	True
vuelto	False
límites	True
impresión	True
negociaciones	False
caballo	True
planes	True
juventud	True
piezas	True
seguía	False
carretera	True
noches	False
negocios	False
mejorar	True
exteriores	True
inmediatamente	True
encontró	False
correspondiente	False
producir	True
técnicos	False
género	False
voto	True
serio	True
privado	True
actuales	False
equilibrio	True
indica	False
beneficios	True
artistas	False
llamar	True
salón	True
periodista	True
aceptar	True
ocurrido	False
perfectamente	False
integración	True
realiza	False
ocurrió	False
pienso	False
cifra	False
siento	False
misión	True
recuperación	True
explicar	True
respondió	False
vivo	False
unidades	False
conversación	True
cuerpos	False
generación	True
incluye	False
sonrisa	True
espalda	True
rojo	True
criterios	True
claramente	False
individuo	True
china	True
negra	False
cuentas	False
asegura	False
patria	True
corrupción	True
belleza	True
prisión	True
interna	False
pareció	False
pecho	True
habitual	False
papá	False
antigua	True
actor	True
comunista	True
víctimas	False
legal	True
segundos	True
establece	False
duro	True
tráfico	True
pacto	True
comprender	True
extranjero	True
requiere	False
dedos	True
azúcar	True
depende	False
fuertes	False
agencia	True
temor	False
interesante	False
campos	True
absoluta	False
físico	False
venía	False
realización	True
creer	False
gobiernos	False
jugador	False
especiales	True
organismos	True
resistencia	True
coronel	True
concentración	True
reconocimiento	False
negociación	True
aparato	True
universal	True
voces	True
perspectiva	True
pedir	True
recuerda	False
rápido	False
motivos	True
diciendo	False
alegría	True
lleno	False
murió	False
independiente	True
factor	True
sexual	True
sonido	True
estudiar	False
posiciones	False
espacios	False
histórica	False
mercados	False
cuadros	False
producen	False
poesía	True
musical	True
participar	True
vacío	True
lectura	True
seguramente	False
cuestiones	False
constituyen	False
banda	True
clima	True
inicial	False
democrático	True
inferior	False
dudas	True
publicidad	True
mirar	False
intelectual	False
vehículos	False
olvidar	True
actuar	False
alcance	True
partida	False
reconocer	True
papeles	False
capitán	True
sucede	True
latina	True
amplio	False
sexo	False
criterio	False
ganado	True
recurso	False
llevan	False
sesión	False
cooperación	False
laboral	True
compra	True
enseñanza	True
utilización	False
categoría	True
apertura	False
presentan	False
abrió	False
abre	False
solidaridad	False
amplia	False
francesa	False
numerosos	False
encontrado	False
empieza	False
lluvia	True
cifras	False
científico	True
ciencias	False
pide	False
directo	True
mostró	False
interpretación	True
forman	False
quedaba	False
formar	False
extraño	False
síntomas	True
punta	False
conseguido	False
determinado	False
liberación	True
sección	True
tensión	True
presentado	False
escala	True
conde	True
árboles	True
suelen	False
alcohol	True
culturales	False
hacían	False
seguido	False
posterior	True
llena	True
supo	False
empleados	True
ojo	False
dura	False
pasando	False
contexto	True
viejos	False
llamó	False
puesta	False
venir	False
inversiones	False
personales	False
presentes	False
instrumento	True
propuestas	False
máxima	False
populares	False
representante	True
células	True
hambre	True
artículos	False
científicos	True
elaboración	False
continuar	True
vicepresidente	True
esperaba	False
tía	True
significado	True
ventaja	True
quedar	False
resolución	True
pausa	True
basta	False
pensando	False
sindicatos	False
alternativa	True
amenaza	True
conversaciones	False
ruido	True
paro	True
jardín	True
código	True
convertirse	False
distinto	True
intensidad	True
madrugada	True
raíz	True
rápidamente	False
reales	False
pensó	False
métodos	False
servir	False
reducir	True
delito	True
completa	False
entró	False
batalla	True
sentencia	False
entorno	True
sociedades	False
negros	True
cita	True
instrumentos	True
semejante	False
españolas	False
vestido	True
turismo	True
construir	True
instalaciones	True
continúa	False
títulos	False
avión	True
comerciales	True
beneficio	True
norteamericana	False
mexicano	True
tasa	False
absoluto	False
candidatos	False
enfermo	False
dominio	True
excepción	False
órdenes	False
nuevamente	False
asesinato	False
pensaba	False
siguió	True
posee	False
completamente	False
escuchar	False
profunda	True
paredes	False
recientemente	False
manifestaciones	False
mirando	False
perdió	False
despacho	False
hablaba	False
ingreso	True
fórmula	True
empezar	True
inicio	True
múltiples	False
seguida	False
víctima	False
llegan	False
recordó	False
vehículo	False
sentimiento	False
mezcla	True
geografía	True
periodo	False
denuncia	True
moda	True
festival	True
vienen	False
espejo	True
pieza	True
expertos	False
convierte	False
comprar	True
drogas	True
príncipe	True
pared	True
dejando	False
registro	True
porcentaje	True
accidente	True
caliente	True
buscando	False
darse	False
ciclo	True
superiores	False
secretaría	False
capaces	False
nacido	True
argentino	True
muchacho	True
inició	False
di	False
lector	True
viva	False
postura	False
explicación	True
conviene	False
ganas	False
funcionario	True
profundo	False
críticas	False
honor	True
ideal	True
triste	False
placer	True
impuestos	True
sentimientos	False
altas	False
dientes	False
textos	False
acontecimientos	False
mecanismos	False
aumentar	False
composición	True
totalidad	True
foto	True
gas	True
comunes	False
tomado	False
agricultura	True
individuos	False
inteligencia	True
modelos	False
baño	True
considerado	False
opción	True
olor	True
índice	False
ganó	False
desarrollar	True
experiencias	True
cerebro	True
exige	False
horno	True
preparación	True
individual	True
moderna	False
habló	False
errores	False
estatal	True
haberse	False
depresión	True
armadas	True
policías	False
señalar	False
estructuras	False
entidades	True
italiano	True
consideran	False
esencial	True
firme	False
global	True
disco	True
supremo	False
absolutamente	True
cargos	True
fotografía	True
distinta	False
polvo	False
humor	True
pintor	True
conceptos	True
vasco	False
naturalmente	False
fracaso	True
recibe	False
complejo	False
acabar	True
abandonar	True
fundamentales	False
creciente	False
restos	True
conocida	False
terminó	False
minuto	True
excelente	True
regreso	True
página	True
discusión	True
déficit	False
ánimo	False
vale	False
reyes	True
numerosas	False
detenido	True
localidad	True
diseño	True
sintió	False
cumbre	True
sueños	True
impuesto	True
fundamentalmente	False
deporte	True
gloria	False
universo	True
convenio	True
pasión	True
jueces	True
luces	False
protesta	True
periódicos	False
estrellas	True
permiten	False
añade	False
definitivamente	False
conocimientos	False
concreto	True
elegido	False
recorrido	False
estación	True
compañero	False
lógica	True
comunicado	True
derrota	True
cierre	True
viven	False
definición	False
campesinos	False
límite	True
comprobar	True
parecido	False
dosis	True
esperando	False
exclusivamente	False
embajador	True
inflación	True
enemigo	True
interno	False
crimen	True
residencia	True
soledad	True
eficacia	True
respectivamente	False
paisaje	True
oír	True
tareas	True
costumbre	True
resultó	False
interesa	False
impacto	True
conocía	False
pasaba	False
estadounidense	False
religión	True
profesores	True
autonomía	True
exactamente	False
componentes	True
cayó	True
norteamericanos	False
asistencia	True
cambiado	False
probable	False
caminos	False
científica	True
duración	True
vías	False
manifestación	True
convirtió	False
malo	False
antiguos	False
obligado	False
enfermos	False
oscuro	False
pura	False
vaso	True
ofrecer	True
marcos	False
petróleo	True
reglas	True
invierno	True
máquina	True
reuniones	True
municipales	False
nacimiento	True
pedido	True
extensión	True
apareció	False
tesis	True
indios	True
vivienda	True
responde	False
pantalla	True
adecuada	True
paseo	True
determinar	True
utiliza	False
toro	True
presidencial	False
implica	False
acabó	False
salido	False
franceses	False
ejecución	False
puro	True
oye	False
consiguió	False
entiende	False
occidental	True
gasto	False
encontramos	False
imperio	False
superar	True
imaginación	True
estabilidad	True
rasgos	False
frontera	True
cubano	True
adecuado	True
gol	False
industriales	False
compañías	False
soluciones	False
catalán	True
marina	False
dificultad	False
trabajando	True
virtud	False
libres	False
observar	True
dirige	False
petición	True
potencia	True
correr	True
anual	False
signo	True
tren	True
órganos	True
propiedades	False
necesarios	True
responder	True
distrito	True
notable	True
clientes	True
mando	False
mecanismo	False
claridad	True
redacción	True
señal	True
actores	True
quiera	False
conclusión	True
ocupa	False
establecido	True
quedaron	False
creado	False
sentado	True
contiene	False
hierro	True
riqueza	True
detalle	True
positivo	False
auto	False
alcanza	False
senado	True
correspondientes	False
frecuente	False
promedio	True
pista	False
piedras	False
amistad	True
puente	True
hogar	True
daño	True
patio	True
otan	False
facultad	True
tropas	True
vuelo	True
demostrar	False
muchacha	False
reflexión	True
consideración	True
editorial	True
tradicionales	False
obligación	True
hipótesis	True
dejan	False
hecha	True
relato	True
llamaba	False
reconoce	False
similares	False
recuperar	True
costo	True
juzgado	False
eficaz	True
pensé	False
orquesta	True
permitió	False
descubrir	True
viviendas	False
gritos	False
poderes	True
ventas	True
fría	True
diagnóstico	True
realizada	False
utilizado	False
silla	False
publicado	False
rechazo	True
prácticas	False
corta	False
loco	False
debo	False
esquema	True
líderes	False
propone	False
desea	False
progreso	True
defender	True
borde	True
remedio	False
transformación	True
ayudar	False
cortes	False
mental	True
verse	False
fortuna	True
aeropuerto	True
escuelas	False
abuela	True
droga	False
levantó	False
exceso	True
disciplina	False
reformas	False
gana	False
delitos	True
difusión	True
hombros	False
elegir	True
tratando	False
planeta	True
mantenimiento	True
civiles	False
hice	False
afecta	False
pierde	True
dimensión	True
ponen	False
pobreza	True
establecimiento	False
prestigio	True
círculo	True
toros	True
transición	True
cumplimiento	True
crea	False
famoso	False
gentes	False
encargado	True
lentamente	True
avenida	True
satisfacción	True
matar	True
pase	False
aplicar	False
viajes	False
dictadura	True
acompañado	False
grados	False
obtuvo	True
colectivo	True
gracia	False
chica	False
indígenas	True
expresa	False
citado	True
cáncer	True
regresar	True
descenso	True
diarios	False
entusiasmo	True
respuestas	True
recuerdos	True
contestó	False
explotación	True
particulares	False
masas	False
manejo	False
sindicato	True
financiero	True
protagonista	False
conflictos	False
aprobación	True
pasan	False
dueño	True
armada	True
telefónica	False
formado	False
sabido	False
dedicado	False
presos	True
controlar	False
consciente	True
liberal	True
conveniente	True
nació	False
dejaba	True
centrales	False
mediados	False
agente	True
montaña	True
publicación	False
cerrar	False
seno	False
dirigido	True
investigadores	False
torneo	True
útil	True
playa	True
lógico	True
subir	True
iniciar	True
escribe	False
golpes	True
próximas	False
terminado	False
universidades	True
revolucionario	True
metro	True
tabla	False
atentado	False
llamadas	False
polémica	True
crítico	True
quisiera	False
particularmente	False
atmósfera	True
descubierto	False
avance	True
evidencia	True
estadio	True
cerrado	True
efectivamente	False
inmediata	False
circulación	True
detenidos	True
dolores	False
apartado	False
anda	False
reconoció	False
muestran	False
dulce	True
escribió	False
terrible	True
permitir	False
campeón	True
gustaría	False
manifiesto	True
asegurar	True
feria	True
trato	False
números	False
edificios	True
extraña	False
determinados	False
señores	False
taza	True
católica	True
fenómenos	False
dada	False
moderno	True
barco	True
ingredientes	True
vender	False
empresario	False
humanidad	False
fácilmente	False
actitudes	False
diga	False
décadas	False
infancia	True
comunicaciones	False
consulta	True
rumbo	False
eléctrica	True
bajar	False
ejemplos	True
blancos	False
legislación	False
llaman	False
ponerse	True
rápida	True
entero	True
rueda	True
mantuvo	False
contó	False
creen	False
campeonato	False
demostrado	False
sustancias	False
necesarias	False
levanta	False
letras	True
andar	True
termina	False
sierra	False
instalación	True
árbol	True
alimentación	True
esquina	True
mexicanos	False
expansión	True
mejora	True
vacaciones	True
alcanzado	False
clasificación	True
reloj	True
huevos	False
banca	False
ciudadano	True
alcanzó	False
raíces	True
deseos	True
impulso	True
comenzar	True
dispone	False
órgano	True
arena	True
opiniones	True
procedimientos	True
maestros	False
anteriormente	False
moneda	True
comandante	True
fiestas	False
viendo	False
creía	False
jefes	False
homenaje	True
cadáver	False
gravedad	True
cantidades	False
siguiendo	False
especialistas	False
informa	False
demuestra	False
advirtió	False
intelectuales	False
signos	False
largas	False
escándalo	True
bajas	False
sensibilidad	True
lágrimas	False
suficientes	True
estancia	True
profundidad	True
argumento	True
comenzaron	False
mostrar	True
tabaco	True
conocidos	False
concurso	True
pertenece	False
largos	False
angustia	True
analizar	True
inicia	False
observa	False
presupuestos	False
tercero	True
aprender	True
dirigida	True
terrorismo	True
llegaba	False
vemos	False
evaluación	True
felicidad	True
socios	True
diría	False
existentes	False
oscuridad	True
manifiesta	False
radical	False
elevado	True
ventajas	False
anuncio	True
arma	True
ceremonia	True
virus	True
colección	False
pude	False
afirmar	True
previamente	False
brillante	True
aparecer	True
comunistas	True
permiso	True
vivido	False
cena	True
dependencia	True
potencial	False
norma	True
ampliación	False
sufrido	False
combate	True
situado	True
cuesta	False
caballos	False
recientes	False
mantienen	False
teniente	True
traje	True
actuaciones	False
impedir	True
proporción	True
corona	True
clásico	True
motor	True
parecían	False
dignidad	True
contenidos	False
dé	False
biblioteca	True
argumentos	True
negativa	False
humo	True
senador	True
corrientes	False
deportivo	False
galería	True
suave	True
colonia	True
concierto	True
rival	True
activa	False
preparado	False
negó	False
escasa	False
continuidad	True
ópera	True
espero	True
toneladas	False
iguales	False
historias	True
decirle	False
definir	True
comisiones	False
aventura	True
comprensión	True
convocatoria	True
artes	False
dedo	True
profesión	True
plantea	False
determinada	True
miraba	False
difíciles	False
provincial	True
canciones	False
oportunidades	True
solar	True
coalición	True
descanso	True
hablado	False
representan	False
promoción	True
reducido	True
aprendizaje	True
cultivo	True
continente	True
chico	True
fechas	False
cubrir	True
síntesis	False
hiciera	False
débil	True
urbano	True
infantil	True
tomando	False
provincias	True
cuentan	False
arquitectura	True
mínima	True
integrantes	True
estrella	True
orientación	True
meta	True
destrucción	True
enemigos	True
pendiente	True
electorales	True
primavera	True
automóvil	True
confusión	True
productores	True
vidas	False
tocar	True
ricos	False
financiación	True
panorama	True
ofreció	True
proteínas	True
permitido	False
abuelo	True
británico	True
relativamente	False
vital	False
sufrir	False
dispuestos	False
celebración	True
eje	True
frecuentes	False
nervioso	True
haría	False
capa	True
atender	False
vivía	False
legales	False
determinadas	True
anoche	False
disminución	True
existir	True
abogados	False
afuera	True
curiosidad	True
variedad	False
mediodía	True
obreros	True
contactos	False
dirigió	False
nariz	True
previa	False
ernesto	False
embajada	True
patrimonio	True
necesitan	False
dejaron	False
afectados	True
reservas	False
créditos	False
sacó	False
romper	True
emoción	True
jurídica	False
risa	True
letra	True
informes	True
oficinas	False
pérdidas	False
vueltas	False
desaparición	True
bandera	True
consejero	False
jurídico	False
formal	True
llamados	False
gira	True
castellano	True
conforme	True
comentarios	False
mexicana	True
acusado	True
notas	True
heridos	False
aumenta	False
utilizan	False
externa	False
reserva	True
responsabilidades	True
pensado	False
núcleo	True
programación	True
sencillo	False
riesgos	False
observación	False
religiosa	False
colectiva	False
cae	False
facilidad	True
amiga	True
frases	True
regular	True
logra	False
dioses	True
símbolo	False
destaca	True
característica	False
mensajes	True
quedarse	False
mandato	True
vivos	False
suficientemente	False
ilusión	False
consenso	True
necesariamente	False
malos	False
cura	True
acababa	False
intentó	False
dimensiones	False
asumir	True
circunstancia	True
fama	True
inútil	True
emperador	True
desaparecido	False
tiro	True
canción	True
venga	False
verdes	False
harina	True
básicos	True
testigos	True
sombras	False
fruto	True
bar	True
espectadores	True
igualdad	False
costumbres	True
relacionados	False
sabor	True
oeste	True
llevaron	False
precisa	False
posesión	True
delegación	True
tasas	False
sostiene	False
ofrecen	False
privadas	False
huesos	True
decidir	True
plato	True
permita	False
setenta	False
ponía	False
hoja	True
convencido	False
reglamento	False
ves	False
vigor	True
financieros	False
aviones	True
insistió	False
lujo	False
policial	False
segura	False
columna	True
ataques	False
corresponsal	True
escritores	True
ramas	False
ácido	True
percepción	True
incluyendo	False
león	True
merece	False
perros	True
presiones	False
destacar	True
provocar	True
beber	True
rigor	True
obtenido	False
mueve	False
plazas	False
etapas	True
dato	True
contratos	False
vigilancia	True
dará	False
sucedido	False
temporal	True
utilizando	False
esencia	True
toca	False
secretos	False
eliminar	False
botella	True
guerrilla	True
grito	True
torre	True
kilos	False
fotografías	False
desarrolla	False
tranquilo	False
monte	True
sujetos	False
caído	False
detuvo	False
daños	False
idioma	True
preparar	True
alemanes	True
dieta	True
añadir	False
firmado	True
perfecto	True
europeas	False
vieron	False
muestras	False
renuncia	False
narcotráfico	True
ordenó	False
favorable	True
rendimiento	True
xx	False
artística	False
dinámica	False
líquido	False
financiera	False
obliga	False
siquiera	False
clínica	True
conclusiones	False
reacciones	True
deber	True
turno	False
terrenos	False
realizan	False
provoca	False
exigencias	True
calma	True
sentirse	False
garantizar	True
llorar	True
intercambio	True
conservación	True
autónoma	True
blancas	False
levantar	True
desarrollado	False
intensa	False
disposiciones	False
enviado	False
salía	False
odio	True
pescado	True
fiscales	False
olvidado	False
examen	True
existía	False
americano	True
vecino	True
opciones	True
roja	False
multitud	True
zapatos	False
precisión	True
cuarta	False
canto	False
usuarios	True
desconocido	True
coches	False
gustaba	False
seco	True
unidas	False
daban	False
imprescindible	False
revisión	True
asociaciones	False
salarios	True
destacó	True
realizadas	False
baile	True
chicos	False
privados	False
entrenador	True
organizado	True
salto	False
orgullo	True
positiva	False
verdaderamente	False
conocen	False
estima	False
contaba	False
raro	False
materias	False
sufrió	False
emisión	True
carreras	False
testigo	True
cristal	True
profundamente	False
retrato	True
danza	True
existente	False
curioso	False
revistas	False
ética	True
ideología	False
ruptura	True
identificación	True
informaciones	False
lento	True
suponer	True
castigo	True
ruta	True
cursos	True
hombro	True
tel	False
goles	True
cumple	False
colocar	False
exportaciones	False
deportes	True
sirven	False
separación	True
nuclear	True
confirmó	False
perfil	True
estética	True
misterio	True
apariencia	True
seguros	True
irse	False
adquirir	True
femenina	True
respaldo	False
península	True
modificaciones	False
procedentes	False
horizonte	True
surge	False
bienestar	True
invitados	True
imaginar	True
uniforme	False
aparentemente	False
condena	False
detención	False
asiento	True
individuales	False
camisa	True
tragedia	True
temperaturas	False
muchachos	False
señales	False
fronteras	True
sienta	False
alternativas	False
hagan	False
santos	True
tendencias	False
comparación	True
bomba	True
expectativas	False
tve	False
rodillas	False
unida	False
testimonio	True
montañas	True
desgracia	True
alemana	False
acercó	False
salen	False
cometido	False
trató	False
publicó	False
participantes	True
ciertamente	False
ventanas	True
caminar	True
encontrarse	False
terroristas	True
institucional	False
templo	True
contaminación	True
bajos	False
clásica	False
escalera	True
médica	False
cercano	False
sustancia	True
protagonistas	False
religioso	False
visitar	False
paquete	True
demandas	True
enormes	False
ligeramente	False
sufre	False
humedad	True
juega	False
heridas	True
recoger	False
candidatura	True
actúa	False
queso	True
ejemplares	False
laboratorio	True
permanecer	True
tienda	True
auténtico	True
claras	False
cantante	True
definitivo	False
tristeza	True
lados	False
bloque	False
parlamentarios	False
obispo	True
concesión	False
vergüenza	True
aprobado	False
defensor	True
enfrentamiento	True
solicitud	True
socialismo	True
refleja	True
halla	False
trayectoria	True
espaldas	False
secuestro	False
ayudas	False
diablo	True
luchar	True
sindical	True
salvar	False
inevitable	True
cebolla	True
cumplido	False
recoge	False
suspensión	False
ocupar	False
capitales	False
tiende	False
alza	False
gris	True
descripción	True
finalidad	False
dólar	True
comienzos	False
actriz	True
peligroso	True
gestos	True
coste	False
garantía	True
auténtica	True
entera	True
alimento	False
femenino	True
verlo	False
cola	True
echar	False
posiblemente	False
amparo	False
prima	False
provocado	False
maíz	True
reflejo	True
asistir	False
mantenido	False
hilo	True
previo	False
impide	False
infraestructura	True
urgencia	True
tranquilidad	True
xviii	False
intenso	True
poblaciones	False
facilitar	True
inmensa	False
nieve	True
intenciones	True
islas	True
conozco	False
presidentes	False
permitirá	False
terror	True
corre	False
ap	False
hacerle	False
provocó	False
fiel	False
destinado	False
afirmación	False
tejido	False
bolsillo	True
acudir	True
incorporación	True
antecedentes	True
extremos	True
amante	False
municipio	True
supongo	False
negociar	False
bosques	False
vocación	False
normalmente	False
piano	True
llegue	False
instrucciones	False
cerró	False
huevo	False
intentos	True
cubanos	True
granada	False
comprende	False
decían	False
espectador	True
cabezas	False
señalado	False
cámaras	False
pasajeros	False
balance	True
sindicales	False
viejas	False
conduce	False
fábrica	True
plenamente	False
domicilio	True
aceptación	True
relativa	True
instancia	True
vigente	False
km	True
ensayo	False
lectores	True
necesitaba	False
terrorista	True
regionales	False
corresponden	False
cubierta	True
dichos	False
iniciado	False
extrema	False
competencias	True
ejercer	False
adiós	True
accidentes	True
humanas	False
irán	False
obligaciones	True
acusaciones	False
oriente	True
mentira	True
rico	False
caras	False
tela	True
fija	False
votación	True
específico	False
pasaron	False
negativo	False
leído	True
cadenas	False
quede	False
emergencia	True
subida	True
compromisos	False
canales	True
premios	True
cerrada	False
incluido	False
comentario	True
quinto	False
singular	True
avances	True
pelota	True
teorías	False
regla	True
pierna	True
parar	True
entrado	False
compuesto	True
concluyó	False
convivencia	True
posteriores	False
corriendo	False
decirse	False
poniendo	False
guía	True
ansiedad	True
empresarial	True
inteligente	True
hermosa	False
propuso	False
volvía	False
continuó	True
generaciones	False
independientes	False
empezaron	True
agrega	False
resultaba	False
comenzado	False
amenazas	False
gubernamental	True
épocas	False
acceder	False
encontraban	False
olvido	True
conoció	False
cambia	False
talento	True
evidentemente	True
empleado	True
rural	True
ambiental	False
entregó	False
efectivo	True
sirvió	False
esperan	False
vanguardia	False
aprovechar	True
cm	True
críticos	False
considerable	False
cero	True
ocurrir	False
desierto	True
músculos	True
literaria	False
exilio	True
escrita	False
explicaciones	False
propuesto	False
nubes	True
funciona	False
colombiano	True
espiritual	False
encontraron	False
entiendo	False
repetir	True
descubrió	False
pusieron	False
adaptación	True
espectacular	False
ríos	True
condenado	True
fotos	False
azules	False
encuentros	False
contraste	True
simples	False
adentro	True
cliente	True
desempleo	True
italiana	True
dices	False
sesiones	False
planos	True
escolar	False
liberales	True
adultos	True
izquierdo	False
extraordinaria	False
salsa	True
advierte	False
tarjeta	True
represión	True
et	False
tesoro	True
locura	False
abundante	True
socio	True
modificar	True
comisario	False
novia	False
caza	True
activo	False
abiertos	False
proyección	False
cubana	True
directores	False
combatir	True
doctrina	True
realizados	False
querían	False
lesiones	True
define	True
distinguir	True
municipios	False
urss	True
abandono	True
adoptar	False
ruso	True
medicamentos	True
explosión	True
renovación	True
perfecta	False
expresar	True
química	True
transmisión	True
modificación	True
concluir	True
pensamientos	False
convertir	True
restantes	False
alteraciones	True
sostuvo	False
trae	False
niega	False
corporación	False
determinación	False
equivalente	False
viviendo	False
internos	True
artístico	False
lanzó	False
urbana	True
rapidez	False
sombrero	True
roca	True
estómago	False
ronda	False
paciencia	True
escapar	False
poema	True
listas	False
apoyar	False
debilidad	True
escritos	True
viajar	True
miseria	False
indispensable	True
visitas	False
otoño	True
plástico	False
ocupación	True
veremos	False
combinación	True
magnitud	True
activos	False
permanece	False
acá	False
ejemplar	True
enfrentar	False
fusión	True
declarar	True
básica	False
cantar	True
limpieza	True
herencia	True
desaparecer	False
poseen	False
pilar	True
extraordinario	False
raza	True
misa	True
cariño	True
resultar	False
aficionados	False
decide	False
culto	True
utilidad	True
deterioro	True
flor	True
escenas	True
sucedió	False
reconocido	False
falso	False
soberanía	True
situada	False
introducir	True
ingeniero	True
efectuar	False
abandonado	True
aniversario	True
filas	False
parlamentario	False
aceptó	False
turistas	True
restaurante	True
incidencia	False
tránsito	False
rojas	False
dibujo	True
vigencia	True
aparente	False
afán	False
retirada	True
frutas	True
documentación	True
parcial	False
prisa	False
pagos	True
denominado	False
trastornos	False
personalmente	False
garantías	False
jurado	True
recurrir	False
incapaz	True
sentí	False
conquista	True
seguirá	False
envió	False
escritura	True
sacrificio	False
tribunales	False
impone	False
saca	False
comando	False
rincón	True
costado	True
concreta	False
sonidos	True
regulación	False
soldado	True
oficialmente	False
acusación	True
infección	True
versiones	False
prevista	False
convicción	True
celebrar	True
sitúa	False
normales	True
perspectivas	True
ucd	False
finanzas	True
anuales	False
introducción	True
sexuales	False
novelas	False
esposo	True
propietarios	False
discutir	True
patrón	False
declarado	False
resultan	False
crees	False
anunciado	False
imponer	False
redes	True
históricos	True
reciben	True
retorno	False
expresiones	False
gerente	True
pistola	True
renta	False
pasillo	True
significativo	False
buscan	False
planificación	True
bruselas	False
versos	False
novedad	False
constantemente	False
máquinas	False
censura	True
sencilla	False
art	True
frutos	False
organizar	True
resumen	True
visitantes	True
policiales	False
planteamiento	False
bella	True
oscura	False
nombrado	False
calificó	False
herido	True
conductor	True
delegado	False
poemas	False
músicos	False
argentinos	True
negras	False
enfoque	True
amarillo	True
caracteriza	False
incluyen	False
corporal	True
considerarse	False
escucha	True
entrenamiento	True
sumamente	False
reparto	True
costos	True
expediente	False
diversidad	True
síndrome	False
colegas	True
gritó	False
continua	False
coordinación	True
cajas	False
acepta	False
ejecutiva	False
balón	True
madres	True
aparatos	False
relieve	False
urgente	True
penas	False
parlamentaria	False
avanzar	True
sitios	False
gramos	False
fresco	False
jugando	False
propietario	True
muebles	False
pendientes	False
espacial	False
despertar	True
carreteras	False
episodio	True
salieron	True
mencionado	True
proteger	True
disponer	False
nacionalistas	False
milagro	True
promover	True
directivos	True
salario	True
limitaciones	True
burguesía	False
efectiva	False
judiciales	False
viuda	True
variable	True
decirlo	False
barrios	False
bellas	False
servido	False
centímetros	True
alturas	True
platos	True
piloto	True
sometido	False
automóviles	False
fiebre	True
únicos	False
llegando	False
británica	True
longitud	True
circular	True
correcta	True
cartera	True
herida	True
echó	False
muerta	True
obtiene	False
ajuste	False
vientre	True
arco	True
formando	False
judíos	True
aprobó	False
grasa	True
semejantes	False
agrícola	False
soportar	False
sensible	True
inferiores	False
basada	False
territorios	False
antiguas	True
cualidades	False
fuga	True
contado	False
musicales	False
estrecha	True
sospecha	True
metido	False
culturas	False
ancho	False
sucesos	False
visible	True
esperanzas	False
adquisición	True
vidrio	True
prepara	False
chileno	True
celebrado	False
preocupa	False
circuito	True
intervenir	True
sorprendente	True
pinturas	False
guardias	False
físicas	False
respiración	True
adn	True
rayos	True
pertenecen	False
elaborado	True
basa	False
oreja	True
ajo	True
barcos	False
mire	False
requisitos	True
ocupado	False
muro	True
integral	True
dichas	True
solitario	True
palma	False
fallo	False
recinto	True
escaso	False
medias	True
poetas	True
culpable	True
agradable	True
piensan	False
directiva	True
consumidores	True
abiertas	False
nombramiento	True
gato	True
indígena	True
fabricación	True
vuelven	False
incluir	True
cambió	False
dibujos	False
empezado	False
marcado	True
señorita	False
contemplar	True
india	True
recordaba	False
xvii	False
comicios	False
coloca	False
crónica	True
autorización	True
rocas	False
laborales	True
malas	False
incendio	True
estable	False
boda	True
traslado	True
embarazo	True
creó	False
caldo	True
dispuesta	False
variables	True
ilegal	True
monarquía	True
denuncias	False
mapa	True
absurdo	True
interesados	False
afectan	False
vientos	True
acontecimiento	False
regalo	True
ordenador	True
estatales	False
ingleses	False
estudiante	True
hábitos	True
perdida	False
conservar	True
famosa	True
continuo	True
hospitales	True
habilidad	False
ahorro	True
básico	False
referencias	False
cintura	False
cotidiana	False
duró	False
presentarse	True
lenguas	False
ejercicios	False
alicia	False
basura	True
hijas	True
fórmulas	False
miel	True
indican	False
trabajador	True
deje	False
acabado	False
cristianos	False
mesas	False
cerveza	True
ampliar	False
aclarar	True
catalana	True
aceptado	False
oriental	True
vivió	False
contempla	False
públicamente	False
esclavos	False
crecer	True
colaboradores	True
prevé	False
infierno	True
interesado	True
afectado	True
verá	False
salas	False
atractivo	True
religiosas	True
presentada	False
relacionadas	False
pecado	True
cigarrillo	False
sillón	False
integrado	False
eliminación	False
juvenil	False
llave	True
revela	False
realizará	False
mostrado	True
campañas	True
encuesta	True
habituales	False
bajó	False
basado	False
té	True
siga	False
poderoso	False
civilización	True
valoración	True
estaciones	True
certeza	False
justamente	False
récord	False
leve	False
incidente	False
transportes	False
esenciales	False
toman	False
refugio	True
limón	True
inquietud	True
impuso	False
consta	False
cierra	False
ajeno	False
regresó	False
específica	False
citada	False
sienten	False
internas	False
tarifas	True
utilizados	False
cálculo	True
lenta	False
faltaba	False
nave	True
oxígeno	True
jornadas	False
habitaciones	True
complejidad	False
dirigir	True
sustitución	True
identificar	True
torres	False
italianos	True
nervios	True
producirse	False
azar	False
guerras	False
militantes	False
futura	True
americanos	False
representar	False
sacerdote	True
construido	True
físicos	False
conexión	True
observaciones	False
recepción	True
guarda	True
cuartos	True
llevando	False
figuran	True
calendario	True
vencer	True
estímulo	False
propaganda	True
concretos	False
exclusiva	True
compartir	False
aliento	False
suiza	True
cercana	False
significación	False
llevaban	False
seca	True
extranjera	True
evento	True
agresión	False
entradas	True
considerada	False
sanciones	True
taller	True
ascenso	True
une	False
maneras	False
guión	False
destinados	False
destacan	False
insiste	False
retraso	False
adolescente	True
árabe	True
leyenda	True
dimisión	True
eco	True
ensayos	False
revés	False
americana	False
admiración	True
variaciones	False
marcas	False
evita	False
hermoso	True
niñas	True
exportación	True
lograron	False
dominante	False
solicitar	True
beso	True
estrictamente	False
plantilla	True
mariana	False
libertades	True
literario	False
pájaros	True
categorías	True
doy	False
disfrutar	True
perfección	False
cancha	True
adquiere	False
excesiva	True
períodos	True
conserva	False
anuncia	False
mierda	False
suprema	False
asistentes	False
entregar	False
crema	True
pregunté	False
específicos	False
investigar	False
personalidades	False
extiende	False
parejas	False
verla	False
dormido	True
denomina	False
creador	True
decenas	False
falsa	False
toque	True
nace	False
carbón	True
catalanes	False
componente	True
rara	False
oyó	False
contribuir	True
suceso	False
cobertura	False
financieras	True
venían	False
cubierto	True
comerciantes	True
consideraba	False
alegre	True
héroe	True
brasileño	True
enviar	False
compositor	True
soporte	True
seria	False
fantasía	True
montaje	True
generar	True
guerrilleros	True
ofensiva	False
racional	False
camión	True
aplica	False
espada	False
celebró	False
obtenidos	False
invasión	True
respectivos	False
puta	False
industrias	False
sucesión	False
visual	True
acumulación	True
afición	True
rica	False
entendido	True
excepcional	True
trimestre	True
facultades	True
aliados	False
armado	False
concretas	False
cuerda	False
justificar	False
muere	True
paga	False
fundamento	True
limpia	True
orilla	True
pensiones	False
correcto	False
consejos	True
sentarse	True
increíble	False
rango	True
inocente	True
presentaron	True
compleja	False
mantenerse	False
relativo	True
genera	False
decidieron	False
cementerio	True
tratados	False
renunciar	True
empezaba	False
reduce	True
irá	False
relacionado	False
genes	True
hielo	True
prevención	True
elevada	False
noble	True
vegetales	False
señalan	False
primaria	False
tecnologías	False
externo	False
sepa	False
transcurso	False
sueldo	True
quedará	False
frecuentemente	False
conocidas	False
rock	True
aviso	True
asalto	True
abandonó	False
delegados	False
decisivo	False
pasados	False
discursos	False
supervivencia	True
duras	False
perdón	True
estadounidenses	False
recibieron	False
orejas	True
invitado	True
emisoras	False
selva	True
satisfacer	True
distinción	True
fases	False
vestidos	False
indicar	True
canciller	True
subió	False
refugiados	False
cortar	False
reto	True
fraude	True
orgánica	True
juntas	False
tocó	False
fiscalía	True
ruedas	False
mito	False
interesantes	False
labores	True
capitalismo	True
sorprendido	False
gubernamentales	False
cansancio	True
inicialmente	False
lejano	False
recorrer	True
sabían	False
bandas	False
normativa	False
rabia	False
reproducción	True
conducir	False
célebre	False
seguimiento	True
roto	False
quedaban	False
proceder	False
rama	True
genética	True
intimidad	True
hechas	False
dedica	False
universitarios	True
cuenca	True
cuadrados	False
solía	False
colombianos	False
administrativa	False
entrevistas	False
armados	False
exigir	False
drama	True
vea	False
requieren	False
caballero	True
coinciden	False
colonial	True
básicamente	False
filme	False
tratan	False
adquirido	False
aves	True
religiosos	False
tensiones	False
densidad	True
carece	False
intérpretes	False
sube	False
clásicos	True
surgió	False
cuartel	True
cuentos	False
apunta	False
hallaba	False
emisora	False
duros	False
comienzan	False
lesión	True
ángulo	False
llamas	False
barro	True
asesinado	False
quedando	False
derivados	False
minerales	True
quinta	False
originales	False
madrileño	True
rumores	False
tramo	False
afrontar	False
muros	True
entendimiento	True
repite	False
básicas	False
barra	True
miradas	False
nacer	True
efectivos	False
tumba	True
extranjeras	False
correo	True
desnudo	True
aseguran	False
hectáreas	True
dedicada	False
pasta	True
simultáneamente	True
iniciativas	True
probar	True
subrayó	False
lanza	False
almuerzo	True
docentes	True
planteamientos	False
bahía	True
cuota	True
inglesa	False
vano	False
educativo	True
horror	True
seguidores	True
publicada	False
rojos	False
permanencia	True
protestas	False
procedente	False
cristiana	False
virtudes	True
piden	False
pelea	True
casado	True
diaria	True
amo	False
metal	True
permitía	False
secuencia	True
fila	True
prd	False
concejal	True
importaciones	False
harán	False
párrafo	False
dormitorio	True
oculta	True
detener	False
carro	True
tiendas	False
admite	False
supuestos	False
aprendido	False
estudia	False
habitualmente	False
curva	True
crece	False
loca	False
incertidumbre	True
magistrado	True
cartel	True
limpio	True
murieron	False
aplicaciones	False
limitado	True
listo	False
dueños	False
apoya	False
estrategias	False
presunto	False
privatización	True
formada	False
elegante	True
tranquila	False
pretendía	False
incluidos	False
and	False
detiene	False
comedor	True
conservador	True
peculiar	True
celebra	False
resultaron	False
procede	False
teatral	False
tronco	True
chino	False
vascos	False
empeño	False
tercio	False
irregularidades	False
precisó	False
lluvias	False
trajo	False
kg	False
vapor	True
monetaria	False
razonable	True
propiamente	False
cristales	False
tejidos	False
corredor	True
exigencia	True
nerviosa	False
promesa	True
quito	False
deseaba	False
costes	False
criminal	True
cinta	True
alumno	True
encuestas	False
conciertos	False
ganador	True
traído	False
especialista	False
cucharada	False
aparecía	False
incapacidad	True
choque	False
garganta	True
invitación	True
venezolano	True
pretenden	False
productividad	True
separado	True
específicas	False
mantenía	False
robo	True
elaborar	False
preguntar	False
arquitecto	True
asombro	True
mentales	True
respetar	False
patas	True
felices	False
bailar	False
mecánica	True
constantes	True
cadáveres	False
unido	False
disminuir	False
bosnia	True
constituido	False
participaron	True
demostró	False
moverse	True
tardes	False
diera	False
hermanas	True
manteca	True
destacado	False
aporte	True
censo	False
adolescentes	True
recta	True
profundas	False
cálculos	False
supuesta	False
comenta	False
aislamiento	False
manolo	False
juzgar	True
acercarse	True
informar	False
jugo	True
estableció	False
huir	True
dama	True
amanecer	False
notar	True
intentando	False
registrado	False
occidentales	False
vayan	False
rostros	False
interpretar	True
satisfecho	False
definido	False
genio	True
notables	False
positivos	False
atlántico	True
tentación	True
entregado	False
secretaria	True
proporciona	False
colegios	True
costas	False
discos	False
informaron	False
enfrenta	False
acusa	False
capítulos	True
mínimos	False
inés	False
celebrada	False
traer	False
israelí	True
pintores	True
clubes	False
provisional	True
entran	False
alarma	True
empate	True
firmas	False
obligados	True
incidentes	True
cuchillo	True
agrícolas	False
trama	True
oral	True
actúan	False
referente	False
instantes	False
giro	True
presa	False
acusados	True
opuesto	True
publicaciones	False
cucharadas	False
parto	True
supuestamente	False
oídos	False
noción	False
directora	False
productor	True
cuero	True
ciudadanía	True
claves	True
combustible	True
obstáculos	False
esfera	True
cocción	True
caracteres	False
modos	False
sabiduría	True
apreciar	True
constituir	True
contienen	False
negar	False
copia	True
modalidad	False
preocupado	True
sorprendió	False
jardines	False
prefiere	False
fieles	False
ocupan	False
permitan	False
problemática	False
partidarios	False
instrucción	True
acento	False
eléctrico	True
oscuras	False
describe	False
indiferencia	True
volvieron	False
sufren	False
participan	False
emociones	True
llevará	False
griego	True
desastre	True
columnas	False
reuter	False
referirse	False
citar	True
acompaña	False
faltan	False
terrestre	True
determina	False
mínimas	False
quita	False
realizando	False
sudor	True
colectivos	False
creyó	False
mencionar	True
semillas	True
ficción	True
ocultar	True
iniciales	False
resuelto	True
nacionalista	True
comedia	True
contemporánea	False
dedicó	False
integran	False
establecimientos	False
sentó	False
manifestado	True
fachada	True
verdaderos	False
monto	True
inmenso	False
inspiración	True
enfrentarse	True
asesor	False
morales	False
obligó	False
creada	False
intervenciones	False
ternura	True
cansado	True
útiles	False
vuelva	False
rodeado	False
ama	False
aportación	False
exista	False
artificial	True
seguían	False
hueso	True
reír	False
firmar	True
planteado	False
desesperación	True
estímulos	False
accionistas	True
cruzar	False
montón	False
fantasma	False
lección	True
tocado	False
nacionalidad	True
presentará	False
sufrimiento	True
cerro	True
encontré	False
votar	True
broma	True
rol	False
afecto	True
funcional	False
alba	True
fijo	False
orígenes	True
vertical	False
suicidio	True
guardar	True
mandatario	True
defectos	False
psicología	True
escultura	True
perdiendo	False
correspondencia	True
pedía	False
académico	True
ancianos	True
pesca	True
soviético	True
peruano	False
electricidad	True
bebé	True
vasos	False
coro	True
cobrar	True
estadísticas	False
alteración	True
postre	True
medir	True
buscaba	False
desarrollados	False
intentado	False
siguieron	False
alcaldía	True
complicado	True
asilo	True
colocado	True
contento	True
hueco	True
flujo	True
andaba	False
bordo	False
obtención	True
índole	False
justa	False
estudiado	False
peores	False
produciendo	False
sentada	True
solucionar	False
capitalista	True
influencias	False
delincuentes	False
complejos	False
capas	True
comidas	False
conocemos	False
ponga	False
informado	True
celebrará	False
organizada	True
gustan	False
vegetal	True
film	False
caos	True
funcionar	False
desafío	True
claros	False
meter	False
indio	True
tormenta	True
territorial	True
diana	False
traducción	True
alas	True
trate	False
finca	True
propósitos	True
acusó	True
acaban	False
respectivas	False
finalizar	True
rosario	False
fuertemente	False
ofertas	False
instalado	True
violación	True
contribución	True
torero	True
ajena	False
partículas	True
trabajado	False
madurez	True
lateral	True
tomaron	False
solicitó	True
inmigrantes	True
masiva	False
instancias	False
mandó	False
consideraciones	False
horario	True
empiezan	False
incrementar	True
pidiendo	False
confederación	True
echa	False
cultivos	True
inspección	True
ámbitos	False
publica	False
celular	True
gobernar	False
trabajaba	False
cocaína	False
agencias	False
terapia	True
aprobada	False
miran	False
manejar	True
direcciones	False
sexto	False
escaleras	False
usos	False
árabes	True
taxi	True
representaciones	False
importe	True
solicitado	False
acero	True
llegaban	False
impresionante	False
altamente	False
círculos	False
chilenos	False
modernos	False
mediterráneo	False
agenda	True
rebeldes	False
picado	False
experto	True
realizaron	False
realizarse	False
balcón	True
tablas	False
difícilmente	False
lecho	False
reunió	False
monedas	True
clarín	False
precedentes	False
llegará	False
plataforma	True
teórico	False
vegetación	False
coincide	True
jugó	False
nucleares	False
vimos	False
conservadores	False
cabello	True
fortaleza	True
ignorancia	True
contener	True
suceder	False
preso	True
litros	False
maniobra	False
latinoamericanos	True
mera	False
anciano	True
refirió	False
excesivo	True
compras	True
den	False
concluye	False
persecución	True
prado	True
cable	True
saco	False
camiones	False
pantalones	True
denominada	False
tomate	True
captura	True
medalla	True
brillantes	False
inauguración	True
abundancia	True
aspiraciones	False
diplomático	True
implantación	False
supera	False
cumplen	False
ridículo	False
completar	True
optimismo	True
hoteles	False
malestar	True
varones	False
titulares	True
éxitos	False
advertir	True
venganza	True
ampliamente	False
bebidas	True
desnuda	True
deriva	False
licencia	True
emocional	True
sonrió	False
docena	False
admitir	True
centroamérica	True
fina	False
saberlo	False
desprecio	True
contradicciones	False
contradicción	True
convencer	False
énfasis	False
entraba	False
integrada	False
cobre	True
pasará	False
concretamente	False
llegué	True
males	False
defiende	False
bonito	True
copas	False
episodios	False
tiros	False
financiamiento	True
huellas	True
diámetro	True
adicional	False
tradiciones	True
cubre	False
componen	False
viajero	True
distancias	False
crudo	True
exposiciones	False
nostalgia	True
veían	False
parcialmente	True
usuario	True
novio	True
carnes	True
senadores	False
ministra	False
grabado	True
cerrados	False
repitió	False
símbolos	True
indicios	True
plantear	False
escolares	False
pisos	False
chicas	True
alrededores	True
suena	False
expuesto	False
rescate	True
crímenes	False
referéndum	False
volverá	False
sobrevivir	False
competir	True
radicales	False
logro	False
referido	False
confirma	False
informativos	False
lago	True
vídeo	False
obispos	False
casualidad	True
contratación	False
llegamos	True
alivio	False
avanza	False
disponibles	True
citados	False
pregunto	False
alerta	True
asesino	True
reside	True
manteniendo	False
oportuno	True
pensión	False
juicios	False
anuncios	True
participó	True
británicos	False
transferencia	True
residuos	True
prestar	False
titulado	False
sacerdotes	False
ideales	False
trascendencia	True
rechazó	False
mortalidad	True
obrero	True
depósitos	True
mostraba	False
apoyado	True
agregar	True
probabilidad	True
denunció	False
cristiano	True
fidelidad	True
simpatía	False
ausente	False
mero	False
flota	True
algodón	True
herramientas	True
abuso	True
enfrentamientos	False
compuesta	True
rodea	False
litro	True
puertos	False
considerados	False
obvio	True
esperaban	False
eficiencia	True
obstáculo	True
progresiva	True
estreno	True
vacía	False
atentados	False
rumor	False
liderazgo	True
destinada	True
creemos	False
metió	False
trámite	True
divisas	True
lanzamiento	True
lee	False
operativo	False
primo	False
sensaciones	True
apellido	True
observó	False
satélite	True
descubre	False
cruel	True
conjunta	False
modernización	True
ironía	True
bloqueo	True
ambientales	False
ofrecido	False
coordinador	True
aborto	True
acordó	False
sanción	True
muertes	True
daría	False
ideológica	False
tecnológico	True
ganancias	True
consumidor	True
puramente	False
ciego	False
deudas	False
nacionalismo	True
eventual	False
reagan	True
aclaró	False
grueso	False
disparos	False
acompañada	False
amable	True
continúan	False
ligero	True
desarrollan	False
mérito	False
norteamericanas	False
billones	False
brillo	True
perjuicio	True
supe	False
débiles	False
pañuelo	True
centenar	False
excesivamente	False
conducción	True
excelencia	False
produjeron	False
volúmenes	False
surgen	False
registros	True
históricas	False
series	True
prioridad	True
expulsión	True
cerebral	True
últimamente	False
señalando	False
retiro	False
desorden	True
exclamó	False
grasas	True
expresado	False
carencia	False
hígado	True
creando	False
músico	False
ejerce	False
acercamiento	False
bolívares	True
cc	True
previsiones	True
fijar	False
sometidos	False
botón	True
prohibición	True
bronce	True
normalidad	False
reveló	False
carbono	True
infinito	True
admitió	False
preocupaciones	False
ocurría	False
conductas	True
sustituir	True
transparente	True
preside	False
célula	False
bombas	False
magia	True
gestiones	False
suelos	False
aérea	False
declara	False
disputa	True
cúpula	True
significativa	False
destruir	True
utilizada	False
depósito	True
registró	False
consolidación	True
rivales	True
manda	False
sostener	False
inconsciente	False
ruidos	False
respecta	False
ubicado	True
universitario	False
japonés	True
emisiones	False
escuchó	False
poderosa	False
secundaria	False
tratamientos	False
rurales	False
ilegales	True
sencillamente	False
vivimos	False
denominación	True
domingos	False
creencias	True
verbal	False
obligada	False
visitante	True
permaneció	False
muchísimo	False
inmóvil	True
unidos	False
viajeros	True
cumplió	False
químicos	False
mover	True
riego	True
fino	False
chilena	True
preguntaba	False
conferencias	False
geográfica	False
fragmentos	True
trago	False
reúne	False
lanzar	True
núcleos	False
credibilidad	True
seda	True
aportar	False
chinos	False
playas	False
pretexto	True
firmeza	False
publicar	True
poética	True
secreta	False
onda	False
inocencia	True
gases	True
escasez	True
incluida	False
indicado	False
ritual	True
masculino	False
rehenes	False
gustado	False
contraria	False
tubo	True
coincidencia	True
interiores	True
atraviesa	False
educativa	False
afirman	False
das	False
colón	False
muscular	True
vaticano	True
continuamente	False
negativos	False
convento	True
confirmar	False
cerdo	True
sacado	True
esencialmente	False
atribuye	True
llanto	False
placas	False
aventuras	False
variación	False
desconfianza	True
investigador	True
salga	False
amantes	True
locos	False
desayuno	True
préstamos	False
colaborar	True
libremente	False
fijado	True
primas	False
seriamente	False
leyendo	False
violenta	False
antena	False
vitamina	True
aparecido	False
privilegio	True
maestra	True
licenciado	True
eterno	False
pertenecientes	False
iglesias	False
tolerancia	True
presentaba	False
evaluar	True
competición	False
índices	True
ácidos	False
validez	True
electrónico	True
placa	True
rusos	False
magistrados	True
promesas	True
localidades	False
corrida	False
novedades	True
ligera	False
estructural	False
fotógrafo	True
limita	False
convencional	False
bolsas	False
sugiere	False
marcador	True
rentabilidad	True
fruta	True
exigen	False
abordar	True
deportiva	False
digno	False
atracción	False
otorga	False
edades	False
existían	False
prohibido	True
configuración	True
madrileña	True
favorables	False
gama	True
órbita	False
marcada	False
gotas	True
extraños	False
logros	True
creatividad	True
jacques	False
fujimori	True
convierten	False
cosecha	True
considerablemente	False
pagado	False
despedida	True
percibir	True
chocolate	True
ola	False
detectar	False
superado	False
realismo	True
serios	False
volví	False
descansar	False
fumar	True
produzca	False
levantado	False
adhesión	False
compuestos	False
ubicación	True
inseguridad	True
presuntos	False
mm	False
cardenal	True
excelentes	False
salarial	False
controles	False
avanzado	True
ropas	False
desapareció	False
rechaza	False
aproximación	True
inclusive	True
penumbra	True
mortal	True
sumario	True
autobús	True
discusiones	False
trigo	True
aportaciones	False
refieren	False
pesado	True
aumentado	False
experimentado	False
causado	False
transparencia	True
tira	False
cenar	False
casco	True
reposo	True
majestad	False
costó	False
reconstrucción	True
concesiones	False
ondas	True
sagrado	True
corredores	True
testimonios	False
formato	True
separa	False
sucesivas	False
minoría	True
insuficiente	True
práctico	False
pantalón	True
elegidos	False
necesito	False
celda	False
residentes	False
urbanos	True
bloques	False
políticamente	False
pollo	True
fundador	False
recomendaciones	False
imposibilidad	True
retirar	False
marcar	False
cercanos	False
revisar	True
repertorio	False
repetición	True
enferma	False
departamentos	False
disparo	False
aprovechando	False
saliendo	False
contemporáneo	False
gala	True
rector	True
famosos	False
fábricas	False
filósofo	True
diariamente	False
excepciones	False
establecidos	False
gordo	True
concejales	True
llenar	True
afectadas	False
metas	False
modalidades	False
pilotos	False
trozos	True
peligrosa	True
exacta	False
terraza	False
ingresar	False
esperado	False
usado	False
escritorio	True
externos	False
prevenir	False
pico	True
jerusalén	True
cerámica	True
capilla	False
enamorado	True
desarrolló	False
bebida	False
pesadilla	True
suavemente	False
pasadas	False
pluma	True
comenzaba	False
duelo	True
pánico	False
delantero	False
observado	False
acudió	False
retórica	True
invisible	True
amarilla	False
indudable	False
quieras	False
ofrecía	False
salidas	False
minas	True
cirugía	True
describir	False
designación	True
oía	False
disminuye	False
rompió	True
estructurales	False
jerarquía	True
hogares	False
debates	False
representado	False
peces	True
ideológico	False
trampa	True
puse	False
levantarse	False
plazos	True
preparados	False
ciudadana	False
llevo	False
formaciones	False
recomienda	False
permanecen	False
protagonismo	False
desean	False
archivo	True
contando	False
sano	True
decisiva	False
legisladores	True
variedades	False
llevarse	False
aumentó	False
antigüedad	True
colega	False
limitada	True
elevar	True
ilusiones	False
transforma	False
partidario	False
vasca	False
llenos	False
disponible	True
justificación	True
méritos	False
fallecido	False
tomaba	False
específicamente	False
reiteró	False
dureza	True
futuros	False
defecto	True
esquemas	False
suponía	False
rebelión	True
estrecho	False
abría	False
corregir	True
prestaciones	False
transmitir	True
aldea	True
expedición	True
entraron	False
conveniencia	True
gasolina	True
hicimos	False
breves	True
aéreo	True
crecido	True
huella	True
pimienta	True
alcanzan	False
dictador	True
fantasmas	True
perejil	True
presidenta	True
realista	True
contestar	True
transformaciones	False
quedé	False
tecnológica	False
republicano	True
importación	True
avanzada	False
hallazgo	True
serenidad	True
ceder	True
vinculación	False
verme	False
analistas	False
billetes	False
reforzar	False
extradición	True
adopción	True
centenares	False
tarjetas	False
despierta	False
gobernantes	False
rehabilitación	True
modernidad	False
eterna	False
aplausos	False
católicos	True
áfrica	False
empleos	False
géneros	False
invertir	False
discriminación	True
maquinaria	False
estricto	True
firmó	False
introduce	False
pasaban	False
vuelos	False
griegos	True
vecina	False
semestre	True
legalidad	True
bello	True
ambición	True
colombiana	True
científicas	False
marqués	True
fatal	True
comunismo	True
peligros	False
frenar	True
movilización	True
tenis	True
jugado	False
mostraron	True
dirá	False
botellas	False
tome	False
tomada	False
haberlo	False
convenios	False
hablamos	False
reducida	False
parezca	False
gafas	True
lamentable	False
oscuros	False
insectos	False
apuntó	False
escuchaba	False
tienden	False
buscó	False
lleve	False
sargento	True
realidades	False
dirigía	False
reunir	True
instinto	True
escribía	False
universitaria	False
falda	False
querida	False
inscripción	True
manchas	True
envidia	True
restricciones	True
informativo	False
romano	True
demostración	True
volar	True
barrera	True
destacados	False
preferencia	True
poseer	True
demuestran	False
mención	True
creencia	True
gigante	True
justifica	False
dejarse	False
aguda	False
grano	False
abundantes	False
elemental	False
espectro	True
archivos	True
uñas	False
motores	False
ambientes	False
mencionados	False
producía	False
desaparece	True
averiguar	True
opina	False
profundos	False
revolucionaria	True
saltar	True
talleres	False
pulso	False
peticiones	False
sólida	False
adolescencia	True
complicaciones	True
generalizada	False
energías	False
experimental	True
caña	False
balanza	True
gallego	True
manipulación	True
constancia	True
coherente	False
portero	False
espectáculos	True
seriedad	True
magnífico	False
hallan	False
caminando	False
patente	True
condenados	False
tratarse	False
merced	False
digamos	False
mató	False
observadores	False
proponer	True
delicado	False
coger	True
ocupó	False
queja	True
corrió	False
típico	True
incorporar	True
óptica	True
producida	False
presidenciales	False
característico	False
cabellos	False
aporta	False
radica	False
jurisdicción	True
horizontal	False
pacífico	True
asociados	False
salvaje	False
quise	False
financiar	True
proporciones	False
captar	True
afectar	True
suelta	False
exacto	False
violento	False
considerando	False
obsesión	True
vestida	False
síntoma	True
supuso	False
palestinos	True
causó	False
construcciones	True
emitir	False
confrontación	True
servía	False
agujero	False
horrible	True
sucesor	True
relatos	False
rodilla	False
dulces	True
adecuadas	False
reportaje	True
cuidadosamente	False
interpretaciones	False
ajenos	False
menú	True
pescadores	False
divorcio	True
grandeza	False
mata	True
inconveniente	False
emprender	False
autos	False
tirar	False
tapa	True
árbitro	True
trozo	False
llamaban	False
despertó	False
pierden	False
tregua	True
traía	False
afectada	False
compañera	False
amigas	True
popularidad	False
surgido	False
perdieron	False
consultas	False
enseñanzas	False
urnas	True
ruinas	False
marcó	False
acostumbrado	False
sofá	True
barba	True
favorecer	False
tradicionalmente	False
fresca	False
celos	False
auge	False
utilizó	True
biografía	True
matices	False
independientemente	False
rusa	True
desprende	False
democráticos	False
retirado	False
paralelo	True
republicanos	False
andaluz	False
jugada	True
varía	False
restaurantes	False
afirmaciones	False
pájaro	True
luchas	False
comprometido	False
juegan	False
conjuntos	False
inminente	False
quejas	False
princesa	True
encuentre	False
apuesta	True
gobernante	True
rosas	True
establecen	False
contribuye	False
montar	False
pce	False
parado	False
íntimo	False
humilde	True
eficiente	True
trabajó	False
fibras	False
salvación	False
aprovechó	False
irregular	True
abiertamente	False
darme	False
vende	False
complicidad	False
amores	False
radiación	True
escenarios	True
vela	False
emplea	False
móvil	True
reunirse	False
digna	False
innumerables	False
judío	False
insistencia	True
sólido	False
constitucionales	False
pasaje	True
resistir	True
tour	True
calcula	False
crean	False
furia	True
pagan	False
amplios	False
damas	False
aprobar	False
comunitaria	False
bolívar	True
invitó	False
pautas	False
retratos	False
encargo	False
conscientes	False
maravilloso	True
valorar	False
refiero	False
electores	True
cese	False
productiva	True
abrigo	True
sed	False
íbamos	False
porvenir	False
vinos	False
caballeros	True
posturas	False
defensores	False
aplicado	False
experimentos	True
salinas	False
consejeros	False
reflexiones	True
diarias	False
dependen	False
trayecto	True
incorpora	False
rompe	True
poderosos	False
llenas	False
patrones	False
lanzado	False
facilita	False
participado	False
gritar	False
armando	False
descrito	False
ira	True
dejé	False
temores	False
productivo	False
escuchado	False
corteza	True
pacífica	False
parámetros	True
comprendido	False
preferido	True
sucia	False
prudencia	True
aparecieron	False
empresariales	False
adecuados	True
liberalismo	True
equivale	False
impulsar	True
maniobras	False
colocó	False
verduras	True
dramática	False
unanimidad	True
democráticas	False
casarse	False
mantequilla	True
sello	False
mercancías	False
héroes	True
precedente	False
pidieron	False
insistir	True
digas	False
caro	True
injusticia	False
precisar	False
saldo	True
participa	False
monumento	True
creciendo	False
intentaba	False
pistas	True
pechos	False
violentos	False
nube	True
ríe	False
químicas	False
dándole	False
regresa	False
economías	False
exclusivo	False
calcio	True
conocí	False
arzobispo	True
favorece	False
docente	True
venden	False
salían	False
interacción	True
carteles	False
provenientes	False
convocado	False
cargado	True
manifestaron	True
implicados	False
asistieron	False
historiador	True
túnel	True
restauración	True
muchachas	True
deseado	False
laboratorios	False
desconocidos	False
quitar	False
pretensión	False
parientes	True
papas	False
hábito	False
encargada	False
comercialización	False
llorando	True
dejaban	False
rutina	True
integridad	True
correctamente	False
continuaba	False
timbre	True
dedicados	False
dominar	True
mundiales	False
monopolio	True
diré	False
torno	False
secundarios	False
alusión	False
pc	False
competitividad	True
íntima	False
aprovechamiento	True
proviene	False
receptor	True
geográfico	False
señalaron	False
moléculas	False
rechazar	True
hallar	False
quieran	False
variantes	False
cambiando	False
coherencia	True
respirar	True
atacar	True
designado	True
mentalidad	True
impotencia	False
sanitario	False
sostenido	False
ubicada	False
anterioridad	False
escaños	False
plenitud	True
llegara	False
conjuntamente	False
transcurrido	True
capacidades	False
limitó	False
proposición	True
existido	False
sillas	False
asume	False
dependencias	True
consultar	True
llamamos	False
electrónica	True
especialidad	False
rtve	False
creció	False
falleció	False
video	True
esplendor	True
energético	True
proporcionar	True
manzana	True
cuotas	False
joyas	False
caía	True
previstas	False
narración	True
desconocida	False
comenzará	False
telefónicas	False
manual	True
rubia	False
juro	False
enlace	True
comentar	False
darles	False
marxista	True
moderado	True
vinieron	False
pronunció	False
préstamo	False
músculo	True
banderas	False
dotado	True
distingue	False
ptas	False
documental	True
adoptado	False
necesitamos	False
practicar	True
paisajes	False
merecen	False
altar	True
biológica	False
porción	True
exactitud	True
bonos	True
únicas	False
aumentando	False
estilos	False
dejo	False
progresivamente	False
apartamento	True
entendía	False
establecida	False
envío	True
destinadas	False
catedrático	True
sobra	True
iniciaron	False
narrativa	True
amplitud	True
duele	False
sospechas	False
rasgo	False
bola	True
potencias	False
metales	False
abarca	False
nobles	False
previstos	False
procedencia	False
ocupaba	False
ordenado	False
tratara	False
significaba	False
extinción	True
modernas	False
veras	False
colonias	True
adecuadamente	False
inconvenientes	False
fibra	True
recuerdan	False
sonar	True
sentimental	True
secundario	False
mueven	False
pasiones	False
teórica	False
buscado	False
trazado	False
frustración	True
compró	False
abren	False
parecida	False
ingenio	True
operar	False
talla	False
varón	True
times	False
máximos	False
responden	False
expone	False
sabiendo	False
pedirle	False
autónomas	False
atardecer	True
cortos	False
colocación	False
ejecutar	True
duque	True
advertencia	True
refería	False
escasas	False
trasladado	False
engaño	True
reflejos	False
dependiente	True
exploración	True
hondo	False
optimista	True
come	False
interminable	True
dedicación	True
consistía	False
campesino	True
saludo	True
agricultores	False
botas	True
excusa	True
asesinos	False
alcaldes	False
gota	True
corría	False
preparando	False
sonríe	False
lana	True
orillas	False
pozo	True
infantiles	False
buques	False
cuadrado	True
inversores	False
planetas	True
receptores	True
plomo	False
molesta	True
comarca	True
adelantó	False
visitó	False
debida	False
urbanas	True
falsas	False
impidió	True
hablo	False
encargados	True
cuidar	True
lástima	False
soviética	False
impulsos	True
víspera	False
dictamen	False
cometer	False
elegancia	True
legitimidad	True
transformar	True
cinematográfica	False
proximidad	True
lazos	False
sucesivos	True
futuras	False
gráfico	True
quiebra	True
brutal	False
risas	False
experimento	True
soviéticos	False
consiguiente	False
caen	False
suponen	False
relacionada	False
dados	True
rayo	True
ritmos	True
pelos	False
acierto	False
pedazos	False
deficiencias	False
legislatura	True
tortura	True
organiza	False
surgir	False
reivindicaciones	False
administrador	False
trámites	False
saint	True
hacerme	False
moción	False
doméstico	False
superficies	False
culo	False
serias	False
semilla	True
agraria	False
lejana	False
delicada	False
umbral	True
conformidad	True
abrazo	True
mencionada	False
traición	True
relevante	False
establecidas	False
nicaragüense	True
cobra	False
borracho	False
extensa	True
acompañar	True
mortales	False
estudiando	False
presta	False
cucharadita	False
psicológico	False
concede	False
sanitaria	False
exhibición	True
consistente	False
enseñar	True
planteó	False
franquismo	True
garantiza	False
efectividad	False
vivían	False
separados	False
lingüística	True
notablemente	False
reflejan	False
empezando	False
nuca	False
foco	True
pesada	True
quedaría	False
reestructuración	True
confirmado	False
granos	False
percibe	False
parada	True
exponer	False
conversión	True
hierba	False
falsos	False
cercanas	False
whisky	True
niebla	False
prometió	False
conforman	False
obviamente	False
superioridad	True
ordenar	False
supresión	False
terminal	True
idiomas	False
disponen	False
formó	False
inestabilidad	True
revelación	True
reunido	False
cómodo	False
sensibles	False
metáfora	False
dadas	False
prisioneros	True
ciclos	False
señoras	False
hablaban	False
secciones	True
adulto	True
psicológica	False
reclama	False
decoración	True
gustos	False
negado	False
natal	False
integrar	True
identificado	False
naves	False
ganando	False
holandés	True
aroma	True
recuperado	False
prudente	True
sabio	True
musulmanes	True
capacitación	True
denunciar	True
dirigidos	False
fármacos	False
dramático	False
organizadores	False
alcanzaron	False
absorción	True
trajes	True
decadencia	False
espejos	False
manifestantes	False
superficial	True
mineral	True
ediciones	False
solemne	True
vitales	False
intermedio	True
lavado	True
cemento	True
sana	False
cuerdas	False
querella	False
conductores	True
cotidiano	False
escribiendo	False
pronóstico	False
informativa	False
encanto	False
lentitud	False
cárceles	False
enseña	False
intervino	True
cogió	False
decirme	False
leyó	False
mágico	True
sutil	False
debidamente	False
inclusión	True
disponía	False
equivocado	False
oración	True
serbios	True
mantuvieron	True
cayeron	False
laterales	True
verdaderas	False
medellín	True
económicamente	False
intervienen	False
portugués	True
gen	False
catástrofe	True
entierro	True
usando	False
cocinar	True
eficaces	False
monstruo	True
tomarse	False
eleva	False
sostienen	False
fauna	True
causar	True
sorprende	False
convocar	False
aceptable	False
pasillos	False
elevación	False
fatiga	True
pureza	False
indicadores	False
presunta	False
negativas	False
bonita	False
sábanas	True
sigo	False
dirigirse	True
canta	False
importaba	False
lema	False
digital	False
medieval	True
asociado	False
situados	False
vínculos	False
hagas	False
dijera	False
tenor	True
flexibilidad	True
recogida	False
representaba	False
contribuido	False
oculto	True
apetito	True
adicionales	True
memorias	True
preparada	False
acogida	False
chaqueta	True
explican	False
medicamento	True
libras	False
comprado	False
colesterol	True
pa	False
certamen	True
pedazo	False
matado	False
pensamos	False
obrera	True
reunidos	False
anunciar	True
frágil	True
urbanización	True
relativos	False
factura	True
significativos	False
movía	False
eléctricas	False
harto	False
solicitudes	True
amnistía	True
confesión	True
conocían	False
cabecera	False
delirio	True
despliegue	False
ocurra	False
determinante	False
jurídicas	False
cargas	False
dependiendo	False
tocaba	False
vitaminas	True
mostrando	False
divertido	True
anécdota	True
volante	False
pido	False
teme	False
bacterias	True
subido	False
cumpleaños	False
táctica	True
insomnio	True
mete	False
penetración	True
nobleza	False
subasta	True
parciales	False
agrupación	True
abuelos	True
suministro	True
funcionan	False
vendido	True
lógicamente	False
pertenecía	False
verle	False
melancolía	True
lapso	False
cigarrillos	False
pondrá	False
recibirá	False
ferrocarril	True
huida	True
acordado	False
amplias	False
deportivas	False
definida	False
romanos	False
peruana	True
comunitario	False
piedad	False
subsecretario	True
localización	True
masculina	False
revolucionarios	False
mancha	True
automáticamente	False
asesinatos	False
registra	False
señalaba	False
pagó	False
recogido	False
clausura	False
clínico	True
instalar	True
buque	True
escoger	False
teléfonos	False
reconocen	False
almas	False
turístico	True
leña	False
heroína	True
campamento	True
típica	False
superó	False
recaudación	True
obtienen	False
retiró	False
partidas	False
mérida	True
acta	True
encargó	False
vinagre	True
elevadas	False
mármol	False
abusos	False
observador	True
infecciones	True
corrección	True
portada	True
cartón	False
inspector	True
creído	False
potente	True
cubiertos	False
teóricos	True
iluminación	True
medianoche	True
limpiar	True
venció	False
limitación	True
intuición	True
efectuado	False
húmedo	True
provocan	False
favorito	False
cd	True
sexualidad	False
dispuso	False
griega	True
catálogo	True
previsión	True
producciones	False
diputación	False
zedillo	False
líquidos	False
escapa	False
indignación	True
rebelde	True
mensuales	False
educativos	False
echado	False
olvida	False
prefieren	False
gustó	False
octavio	False
vacas	True
concluido	False
cintas	False
confesó	False
correspondía	False
abriendo	False
dejará	False
ala	False
desempeño	False
válido	False
empecé	False
recibía	False
bala	True
decidida	False
criminales	False
secas	False
curiosa	False
mundos	False
hongos	True
privilegios	False
afiliados	False
patronal	False
iría	False
rodean	False
permanentemente	False
piscina	True
domina	False
plumas	True
pintar	True
traduce	False
perfume	True
disolución	False
coraje	True
palos	False
abandona	False
conducido	False
mandos	False
extremadamente	False
expresamente	False
mejillas	False
trono	True
implacable	False
opera	True
arreglo	True
xv	False
pretensiones	False
obedece	False
conceptual	True
rincones	False
corbata	False
aislado	True
tardó	False
fortalecer	True
autonómico	False
exámenes	False
asistió	False
señas	False
muñeca	False
puentes	False
preguntado	False
movilidad	True
vejez	True
olímpicos	True
separar	True
generado	False
desfile	True
sistemática	True
significar	True
viajó	False
continuará	False
informática	True
sucio	True
anualmente	True
cotización	False
leonor	True
volviendo	False
rutas	True
prometido	True
ejecutivos	False
fomentar	True
deberes	True
pongo	False
desenlace	False
autobuses	False
meterse	False
ayudó	False
disciplinas	False
coyuntura	False
aislados	False
consuelo	True
corren	False
grabación	True
viera	False
provocando	False
lámpara	True
carecen	False
estatura	True
penetrar	False
misterioso	True
nacidos	True
examinar	True
predominio	True
atenas	False
editor	True
barato	False
cajón	False
viste	False
delincuencia	True
japoneses	False
radicalmente	False
distante	False
horarios	False
copias	False
producidos	False
alejado	True
fijos	False
turística	False
católico	False
militante	True
relevancia	False
sustancial	False
llevada	False
ajenas	False
nombrar	False
ordenamiento	True
fabricantes	True
aviraneta	False
cumpliendo	False
dirigidas	False
inversionistas	False
porcentajes	False
victorias	False
seminario	True
macho	True
baloncesto	True
consolidar	False
calificación	False
estadística	True
madrileños	True
ayudante	True
preferible	False
verso	True
seleccionar	False
temporadas	False
quitó	False
asumió	False
comprobado	False
seguimos	False
charla	True
ocio	True
olas	True
esculturas	False
poseía	True
trastorno	True
plantel	False
mañanas	False
objetiva	True
estimular	False
francesas	False
retirarse	False
repercusión	True
autonómicas	False
suspender	False
mecánico	True
condujo	False
dedicarse	True
detenerse	True
barroco	True
reflexionar	True
evitando	False
véase	False
procesamiento	True
llaves	False
israelíes	False
mantendrá	False
cortado	True
dormía	False
invita	False
dedican	False
envuelto	False
meramente	False
padece	False
aumentos	False
ingeniería	True
complemento	False
guerrillero	True
asciende	False
bancaria	False
muslos	False
extendió	False
tendido	False
vendedores	False
matemáticas	False
vinculados	False
hembra	False
manifiestan	False
proteína	True
romana	True
formalmente	False
afirmaba	False
penales	False
poblado	False
creativo	True
monseñor	False
adquirió	False
conspiración	True
aplicada	False
vulgar	True
jazz	True
invención	False
maleta	True
subvenciones	False
vinculado	False
pares	False
saldrá	False
concedido	False
suman	False
aficionado	True
diplomática	False
matanza	True
directos	False
defendió	True
perdía	False
ruina	True
insoportable	False
perdidos	False
comportamientos	False
atletas	True
pálido	True
mide	True
falla	True
generosidad	False
complutense	True
quedamos	False
primordial	False
orgulloso	False
ciega	True
requerimientos	False
consideramos	False
apropiado	False
sorpresas	False
veterano	True
maneja	False
rodaje	False
asegurado	False
advertido	False
oí	False
menciona	False
hegemonía	True
setiembre	False
sustituido	False
elementales	False
agudo	False
secos	False
herramienta	True
peruanos	False
emite	False
amar	False
peligrosos	True
concedió	False
artísticas	False
comprendió	False
parques	False
cometidos	False
imposición	False
cuidados	False
naturalidad	True
pata	True
océano	False
controla	False
cerradas	False
autónomo	True
inclinación	True
sentados	False
rechazado	False
grita	False
permitiría	False
fomento	True
relativas	False
culpables	False
acompañó	False
contesta	False
venezolana	True
permanecía	False
faena	False
repetía	False
monarca	True
jugaba	False
gráfica	True
feroz	False
valiente	True
conceder	True
reunieron	False
dispositivo	False
dialéctica	False
especializados	False
pulmones	True
fáciles	True
rastro	True
cobro	False
vencedor	True
portal	True
vacuna	True
devolver	True
utilizadas	False
oliva	True
velas	False
bomberos	False
receta	True
persigue	False
verás	False
dueña	False
ángeles	False
biológico	True
vencido	True
entrando	False
pretender	False
orina	True
terremoto	True
disgusto	False
abismo	True
televisor	True
excesos	False
patatas	False
puño	False
cruce	True
estético	False
monjas	True
lealtad	True
kilo	False
aspirantes	True
preferencias	True
puntas	False
significativas	False
mediación	True
mandar	True
mejoramiento	False
genético	False
demócrata	True
filial	True
lucía	False
mentiras	True
sueldos	False
leía	False
bruscamente	False
africanos	False
clínicas	False
sospechoso	True
comparten	False
analiza	False
fracción	False
paja	False
reclamar	True
consiguieron	False
elevados	False
fundada	True
mueren	False
recordando	False
servirá	False
colmo	False
logran	False
ayuntamientos	False
desconoce	False
regímenes	False
relevantes	False
tonos	False
eventos	False
constituyó	False
formulación	False
procurador	True
curvas	False
bondad	True
sirva	False
molestias	True
indicaron	False
asunción	False
ratos	False
llamo	False
extrañas	False
haití	True
haré	False
agrupaciones	False
sometida	False
barreras	False
contemporáneos	False
asco	False
casada	True
golfo	False
romántico	False
triunfos	False
rencor	True
preservar	True
reaccionar	False
mejoras	False
diseñado	True
anillo	True
interlocutor	True
mágica	False
previos	False
ordena	False
incendios	False
desnudos	False
comunitarios	False
patología	True
sonriente	True
presentados	False
identifica	False
anselmo	False
expresan	False
estratos	False
museos	False
coge	False
abrirse	False
publicados	False
terapéutica	False
introdujo	False
representada	False
sobrino	False
guerrero	True
seleccionado	True
prestado	False
bolsillos	False
cómoda	False
unen	False
divino	False
compensación	True
extendido	False
magnífica	False
japonesa	True
fantasías	False
prendas	False
asesores	False
ladrillos	True
externas	False
enfermera	False
reservados	False
contundente	False
comisaría	False
divina	False
movió	True
electorado	True
reservado	True
entienden	False
trágico	False
viaja	False
frentes	False
girar	True
susto	False
solicita	False
directivo	False
cambian	False
especializado	True
american	True
fabricar	True
mama	False
prolongado	False
sumar	True
ayudado	False
mediano	False
acudieron	False
tarifa	True
presentadas	False
actuó	False
desagradable	True
escuchando	False
hacerla	False
cristóbal	False
dejara	False
prejuicios	False
clic	True
redonda	False
darán	False
abstracción	True
crónicas	False
comparecencia	False
mediana	True
consistencia	True
defenderse	False
previsible	False
tremenda	False
arreglar	True
cubiertas	False
creadores	True
registraron	False
ánimos	False
formales	False
camilo	False
cia	True
belga	True
ente	False
legalmente	False
considero	False
opone	False
acercaba	False
volvería	False
comunicó	False
evidentes	False
calificado	True
vendrá	False
preguntarle	False
monasterio	True
solares	False
degradación	True
bordes	False
transformado	False
enseñó	False
motivación	True
salones	False
vestir	True
desarrollada	False
terceros	False
legislativas	False
cuna	True
destinos	False
indiferente	True
actuando	False
administrativas	False
apoyó	False
deportivos	False
bandeja	False
autora	False
bruto	False
anti	False
vigentes	False
dobles	False
permanentes	False
pobladores	False
trance	True
firmes	True
complejas	False
permitieron	False
decimos	True
porqué	False
latín	True
acompañan	False
injusto	False
sonriendo	False
federales	False
desarrollando	False
tremendo	False
compositores	False
bajando	False
generan	False
carros	False
acude	False
inevitablemente	False
denunciado	False
cielos	False
incorporado	False
expedientes	False
demonios	False
intérprete	True
encerrado	True
contrabando	True
infinita	False
metodología	True
partió	False
interpreta	False
explicado	False
ligado	False
prosa	True
levantamiento	False
probado	False
eternidad	True
iniciada	False
indiscutible	False
sales	False
criticó	False
bancario	True
dejen	False
institucionales	False
naval	False
creí	False
átomos	False
cantando	False
variar	True
aumentan	False
hable	False
discípulos	False
jurídicos	False
impunidad	True
haz	False
articulación	True
autonómica	False
recibiendo	False
influir	True
relevo	True
modesto	True
inmigración	False
mensual	True
facilidades	False
gorda	True
euforia	True
nicaragüenses	True
cantos	False
atravesar	True
comparte	True
trasladar	False
baleares	True
muelle	False
agresividad	True
picada	False
grabados	False
resultante	False
expectativa	False
citas	True
comparar	True
dorado	True
llamarse	False
provinciales	False
haberle	False
académicos	True
escritas	False
vacíos	False
coca	False
azulgrana	False
parados	True
ladrones	True
publicitario	True
atraer	True
amado	False
entenderse	False
conquistar	False
disponibilidad	False
devoción	False
aprecia	False
laberinto	True
puñado	False
che	False
extraer	False
explicaba	False
ramo	False
acorde	False
plástica	False
duerme	False
pasaporte	True
terminan	False
supervisión	True
llamaron	False
centavos	False
jugará	False
regalos	False
resuelve	False
cayendo	False
aspiración	True
inocentes	True
diplomáticos	False
manta	False
pinta	False
interrumpió	False
vínculo	True
contienda	False
medina	False
trenes	False
kilómetro	True
simbólico	False
exclusión	True
tazas	False
refiriéndose	False
narrador	True
mina	True
juzgados	False
demonio	True
recorte	False
vivas	True
dependerá	False
reconocida	False
aristóteles	True
conservan	False
montado	False
llevaría	False
mantenga	False
suaves	True
rotación	True
ordenación	False
clemente	False
enterado	False
instrumental	False
fríos	False
sopa	True
sucesivamente	False
procesión	True
acompañados	False
observando	False
químico	True
camas	False
cortas	False
vestuario	False
citadas	False
adoptada	False
cima	True
pertenecer	False
tiró	False
admirable	False
satélites	False
atento	False
ingenieros	True
calificar	False
chimenea	True
prolongada	True
aliado	False
complicada	True
armamento	False
descarga	True
aspira	False
recipiente	False
telecomunicaciones	True
apoyada	False
confía	False
totales	True
pintado	True
orlando	True
bolso	False
llegaría	False
rito	False
conlleva	False
grises	False
confirmación	False
ida	False
niñez	True
incluidas	False
convención	True
quisieron	False
venezolanos	False
sumo	False
demócratas	False
rentas	True
goma	True
anunciada	False
sarajevo	True
continental	True
exigía	False
calcular	True
extender	True
genial	True
armario	True
plantean	False
abrieron	False
religiones	False
lecturas	False
lograba	False
invento	False
formaban	False
representados	False
caridad	True
mitos	False
investiga	True
digan	False
márgenes	False
dolorosa	False
artificiales	False
combustibles	False
cenizas	True
soñar	True
compás	False
objetividad	False
significados	True
fotógrafos	False
sólidos	True
contará	False
negación	False
historiadores	True
ancha	False
desequilibrio	True
pabellón	False
origina	False
vacías	False
tristes	False
novelista	True
cruzó	False
inversa	False
etarras	False
reelección	True
variados	False
comodidad	True
antepasados	True
alquiler	True
entrañas	False
especializada	False
convirtieron	False
goza	False
prioridades	False
dividido	False
peseta	True
impresiones	True
camiseta	True
andan	False
publicitaria	True
positivas	True
supiera	False
alterar	True
verdades	False
multa	True
caracterizado	False
húmeda	True
templos	True
previas	False
consideradas	False
paralela	True
profundizar	False
marino	True
siniestro	False
violaciones	False
repetidas	False
añadido	False
podíamos	False
galerías	False
ritos	False
legislativo	False
uruguayo	True
psicosis	False
puestas	False
enterarse	False
apoyan	False
gatos	False
roque	False
razonamiento	True
pasaría	False
cruza	False
inquietudes	False
agregado	False
manzanas	False
aleja	False
temática	False
gozar	True
hilos	True
marxismo	True
inesperado	False
prefiero	True
disparar	False
descarta	False
ceremonias	False
bares	False
presidido	False
incorporarse	True
prestación	False
latinoamericana	False
actuado	False
llamamiento	False
recomendable	True
siembra	False
mares	False
realice	False
cuantía	True
estatutos	True
diferencial	False
venas	False
confundir	True
remate	False
lata	False
requisito	True
aguantar	False
cualidad	False
vistas	False
votantes	True
formular	False
organizó	False
arquitectos	True
replicó	False
presidida	False
imagino	False
dejarlo	False
termine	False
salí	False
mercancía	False
autopista	True
pesados	True
molde	False
apuntan	False
transmite	False
sonora	True
derrotado	True
trasladó	False
verte	False
conversar	False
jubilación	True
arias	False
queden	False
cantantes	False
construida	True
académica	False
pekín	True
desconcierto	False
prólogo	True
veamos	False
guardaba	False
procesado	False
damos	False
constituida	False
cráneo	True
defensiva	False
ratón	True
gravemente	False
espontánea	True
mejoría	False
cristianismo	True
energética	True
huelgas	False
inútiles	False
impiden	False
existan	False
perderse	False
tinta	True
unir	True
primitivo	False
relleno	False
disparó	False
párpados	False
apartados	False
comunicar	True
franja	False
gratuita	False
inesperada	False
nomás	False
desaparecidos	False
literalmente	False
auditorio	True
divide	True
sinceridad	True
ajedrez	True
terribles	False
gobernadores	False
embarazada	False
contenida	False
interviene	False
operan	False
físicamente	False
almirante	True
burla	False
registrados	False
consumir	True
caracterizan	False
tocando	False
imaginario	True
miserable	True
competente	True
generalizado	False
discreción	False
diferenciación	False
pianista	True
contribuyen	False
manifestar	True
respondía	False
terminaba	False
consigna	False
semejanza	False
adversario	True
contribuyó	False
cumpla	False
estricta	False
sábados	False
agonía	False
deportistas	False
proponen	False
matrícula	True
diplomáticas	True
recibida	False
subiendo	False
decidí	False
resoluciones	True
parroquia	True
ejércitos	False
coincidieron	False
latinoamericano	True
convencidos	False
pronunciado	False
extracción	True
proyecta	False
ocupada	False
severa	False
anotó	False
cascos	False
progresivo	True
curación	True
masivo	False
conducen	False
atractiva	False
manto	True
izquierdas	False
misiones	False
defensas	False
sujeta	False
prefirió	False
fijación	False
billete	True
especulación	False
feo	False
innovación	True
provecho	False
burocracia	False
gruesa	True
esferas	False
preferentemente	False
expulsado	True
retira	False
patrocinio	True
salvó	False
suscrito	True
delgado	True
irme	False
extenso	True
sustancialmente	False
bancarias	False
conservadora	False
encontrará	False
pasé	False
comprendo	False
compartido	False
valía	False
fundamentos	True
vuelvo	False
efectúa	False
ético	False
cercanías	False
expuso	False
pesa	False
segmento	True
seguirán	False
jamón	True
centra	False
helicóptero	True
operadores	True
marinos	False
lleguen	False
retroceso	False
espaciales	False
adelantado	False
matriz	True
caudal	True
llevamos	False
crecen	False
nocturno	True
múltiple	True
nuboso	False
yendo	False
determinan	False
gallina	False
mejorado	True
virtual	True
fundado	True
misiles	False
medallas	False
controlada	False
abstracto	True
primario	False
juveniles	False
sacrificios	False
suspendido	False
ordenadores	False
maravilla	False
códigos	False
intentaron	False
gritando	False
superación	False
esclavitud	True
construye	False
paulatinamente	False
besos	False
preguntarse	False
generoso	True
tramos	False
salvado	True
miraban	False
biblia	True
acabo	False
hicieran	False
riguroso	True
escudo	False
lecciones	False
insuficiencia	True
serrano	False
curar	True
recorre	False
reparación	True
intensamente	False
escondido	True
nieto	False
introducido	False
significó	False
bestia	False
concretar	False
expuestos	False
atiende	False
disimular	True
voluntariamente	False
paquetes	False
queriendo	False
multinacional	True
sodio	True
preocupante	False
situar	False
recomendación	False
administrativos	False
freno	True
consume	False
homicidio	True
pactos	False
ocurriendo	False
observan	False
hervir	False
potenciales	True
ingresó	True
heredero	True
francos	False
ponían	False
estudió	False
indemnización	True
séptimo	False
profesorado	False
indicaciones	True
sencillez	True
paradoja	True
ocurren	False
inventado	False
canela	False
excitación	True
compensar	False
frescos	True
homosexuales	True
estrés	False
adversarios	False
calorías	True
confiar	True
variadas	True
temía	False
protegido	True
afueras	False
diligencias	False
descender	False
romántica	False
envía	False
plana	True
hispano	False
lejanos	False
quehacer	False
álbum	True
celeste	True
borrar	True
temprana	False
aseguraba	False
relaciona	False
ganancia	False
involucrados	True
pasamos	False
válida	False
arranque	False
senos	False
bailes	False
cómplice	True
filósofos	True
impuesta	True
deseable	False
legítimo	True
almacén	True
inquietante	True
controlado	False
feto	True
saltó	True
acompañaba	False
situarse	False
industrialización	True
decida	False
llenó	False
maravillosa	False
enmienda	False
voluntarios	True
captación	True
atenta	False
aportes	True
esperamos	False
efectuó	True
ordinario	True
acera	False
visibles	False
melodía	True
narcotraficantes	True
navegación	False
variante	False
concepciones	False
reúnen	False
rubio	False
robado	False
productivas	False
iniciación	False
idéntico	False
optar	False
pez	True
brigada	False
potable	True
sonreír	True
camina	False
califica	False
inauguró	False
adquieren	False
precauciones	False
resolvió	False
pegado	False
gestación	True
verán	False
variado	False
moderada	False
toreo	True
visiones	True
empleada	False
rodeada	False
incapaces	False
presuntamente	False
fianza	True
centenario	True
ilustre	True
fundó	False
monumental	True
dotación	False
partiendo	False
consecución	True
doctora	False
reparar	True
bebe	True
traen	False
ecuación	True
acabaron	False
colaborador	True
mitin	False
usados	False
cortinas	True
mineros	True
esconde	False
pedí	False
detectado	False
maldito	True
aseguraron	False
asociada	False
producidas	False
dedicadas	False
tomo	False
terminaron	False
rescatar	True
tomates	False
desesperado	False
espíritus	False
conexiones	False
proporcional	False
decirte	False
absurda	False
procuraduría	False
dudar	True
agotado	False
otorgar	True
monetario	True
desigual	False
cuaderno	False
telón	False
procesados	False
pasear	True
temporales	False
definen	False
sospechar	True
mono	False
luchando	False
temo	False
redujo	False
estratégico	False
dirigen	False
cirujano	True
yemas	False
vitalidad	True
vicio	False
estratégica	False
doloroso	False
sucedía	False
primitiva	False
valioso	False
utopía	True
poético	True
ofreciendo	False
puros	False
calientes	False
descubrimientos	True
uniformes	False
mutuamente	False
elegida	False
desempeñar	False
dijiste	False
precisas	True
reconstruir	True
tacto	True
incorporó	False
enormemente	False
creyendo	False
cortó	False
estrechamente	False
reconciliación	True
dispersión	True
veneno	True
vertiente	False
recogen	False
colocan	False
faltas	False
electrones	True
insólito	False
producirá	False
vengo	False
láminas	False
proceden	False
temblor	True
protocolo	True
cinturón	True
alianzas	False
confiesa	False
adaptarse	True
higiene	True
someterse	False
helms	False
palinuro	False
triángulo	True
réplica	False
criado	False
aluminio	True
perteneciente	False
invertido	False
sanitarios	False
filosófica	False
confuso	True
bata	False
américas	False
revelan	False
enteramente	False
unánime	True
levemente	False
legado	True
acuden	False
sitúan	False
compasión	True
temer	False
cruzado	False
permanecido	False
misteriosa	False
muertas	False
aviación	False
trapo	False
composiciones	False
hierbas	False
cortesía	False
rallado	False
nacen	False
coma	True
convencimiento	False
recesión	True
medicinas	False
compatriotas	False
voluntaria	False
cuadra	False
alcoholismo	True
violín	True
camarero	True
surgieron	False
futbolista	True
ejes	False
quedo	False
almacenes	False
dedicar	True
textura	True
reclamo	True
silueta	True
ayudan	False
aceptada	False
anciana	False
ecológico	True
literarios	False
nacho	False
sigan	False
explotar	False
futbolistas	False
batallas	False
especialización	True
asumido	False
convirtiendo	False
racionalidad	False
metálico	False
bastón	True
tecnológicos	False
frontal	False
vendedor	True
ratas	False
depresivo	False
depresiones	False
educativas	False
renacimiento	True
soberbia	True
despertado	False
entrenamientos	False
retención	True
crueldad	True
sufrieron	False
subraya	False
tomadas	False
salimos	False
valles	False
diálogos	False
recto	False
convergencia	False
divisa	False
auxilio	True
optó	False
gritaba	False
saliva	True
proliferación	False
prever	True
vean	False
facciones	False
divisiones	False
olla	True
nómina	False
seguidos	False
hormonas	True
convocó	False
hornos	False
idiota	True
levantaba	False
liquidación	True
pasajes	False
rápidos	False
lienzo	True
secuestrado	False
alcanzaba	False
apreciación	True
manga	True
comentado	False
largamente	False
enmiendas	False
semanario	False
creían	True
interesaba	False
revelado	False
desacuerdo	False
flexible	True
atrevió	False
libra	True
balas	False
dejamos	False
correlación	True
marchó	False
serpiente	True
ligada	False
limitar	True
mencionadas	False
interesan	False
fotográfica	False
ministerial	False
prosperidad	True
excepcionales	False
escape	True
enviados	False
discreto	True
discípulo	False
pascual	False
cereales	True
silenciosa	False
sonoro	False
crucial	True
fijó	False
repercusiones	True
sendero	True
aparecían	False
nudo	True
mejilla	False
canadiense	False
estallar	False
erosión	True
obtuvieron	False
emisor	True
aceptan	False
cineasta	True
anunciaba	False
encabeza	False
cauce	True
lavar	True
obligatorio	False
eligió	False
flamenco	True
rebaja	False
descontento	True
ricas	False
tope	False
polo	False
considere	False
economista	True
ocupados	False
preocuparse	False
coincidir	True
niegan	False
circuitos	False
restante	False
demora	False
indirectamente	True
despejado	True
simpático	False
recetas	False
oyentes	False
licencias	False
dorada	False
cueva	False
molesto	True
africano	True
encierra	False
concentraciones	False
cinematográfico	False
pronunciar	True
curiosos	False
quieto	False
velada	False
inspectores	False
unirse	False
hidrógeno	False
amargo	False
terrestres	False
encender	True
apoyos	False
dinámico	False
administrar	False
convocada	False
geometría	True
secuencias	False
montes	False
soltó	False
regulares	False
progresista	True
corrido	False
narices	False
mostrador	False
minorías	False
recuento	False
tropical	True
acuerdas	False
padecen	False
agresiones	False
prostitución	False
cuñado	False
aurora	True
recogió	False
gradual	True
administraciones	False
aclara	False
cogido	False
tumores	True
liberalización	True
fragmento	False
estalló	False
titulada	False
jacinto	False
protestar	False
critica	False
brisa	True
amarillas	False
focos	True
custodia	True
mutuo	True
razas	False
cohesión	True
quedarán	False
candidaturas	False
obtenida	False
durar	True
mate	True
extremidades	False
preocupes	False
faltó	False
cargar	False
fósiles	True
regula	False
cerco	True
decepción	False
insultos	False
cesar	False
prosiguió	False
convencionales	False
sandinistas	True
espectaculares	False
tibia	False
legislativa	True
auténticos	True
liberar	True
mayoritario	False
nocturna	False
combinaciones	False
encendido	False
rendir	False
enteros	False
maldita	False
nativos	True
precioso	True
telas	False
eléctricos	False
desarrollarse	False
contratar	False
brasileña	False
alejarse	True
indicación	False
guardan	False
sonó	False
viabilidad	False
sugerencias	True
construyó	True
discrepancias	False
socialmente	False
palmas	False
lineal	False
explosivos	True
combates	False
vísperas	False
provienen	False
aplican	False
sexta	True
agradecimiento	True
evidencias	False
móviles	True
ventanilla	False
repetido	True
subrayar	True
cabía	False
movido	False
legislador	True
orientales	False
formidable	False
descendientes	False
musculares	False
hermosas	False
dionisio	False
helado	False
renovar	True
vayas	False
comercios	False
tomas	False
escogido	False
vocales	False
espuma	False
aplicarse	False
vendría	False
bando	False
monumentos	True
precisos	False
seleccionados	False
aguja	False
batería	True
contribuyentes	False
hallazgos	False
abastecimiento	True
gigantesco	False
dispuestas	False
visuales	False
codo	True
afortunadamente	False
terminada	True
formados	False
precipitaciones	False
torpe	False
avanzando	False
enteras	False
talante	False
recibo	False
inserción	False
rodar	False
marcharse	False
mutua	False
interpretado	False
funda	False
toreros	False
llamando	False
autorizado	False
incómodo	False
lucrecia	False
derivadas	False
mudo	True
diosa	False
fugaz	False
suavidad	True
fracasado	False
activamente	False
rige	False
vitoria	False
arcos	False
suizo	True
despido	True
prescindir	False
botones	False
sugirió	True
ofrecieron	False
ignorar	True
dominación	True
designar	True
mozo	False
implicaciones	False
enfrentan	False
francamente	False
determinó	False
amorosa	False
rentable	False
resaltar	True
organizados	False
preparan	False
inmediatos	False
anunciaron	True
calibre	True
sumó	False
originalidad	True
lucidez	False
cocido	True
vestíbulo	True
ezequiel	False
históricamente	False
estables	False
finas	False
guapa	False
pipa	False
republicana	True
bajado	False
protector	True
cejas	True
sentencias	False
rebeldía	False
desesperada	True
parecidos	False
ignora	False
cortina	False
cubren	False
comprobó	False
opositores	False
interrogantes	False
colecciones	False
resta	True
reproducir	True
suceden	False
tirado	False
agitación	True
amargura	False
devolución	True
sostenía	False
iniciará	False
subía	False
envergadura	True
mandado	False
vértigo	False
ángulos	False
idéntica	False
instaló	False
recuperó	False
corridas	False
alzó	False
murmuró	False
arranca	False
estallido	False
lío	False
certificado	True
disminuido	True
extra	True
celebran	False
vinculadas	False
severo	False
exigió	False
enfermería	True
asoma	False
comerciante	True
castellana	False
creativa	False
prolongación	True
encuentren	False
especializadas	False
domésticos	False
definió	True
membrana	True
liberado	False
excursión	True
concentrado	False
trataron	False
doctores	False
faltaban	False
conducía	False
ascensor	True
aconsejable	False
cal	False
ponerle	False
capricho	False
quedara	False
asientos	False
cátedra	False
dispositivos	False
vería	False
acostumbrados	True
dinamismo	False
contemplación	True
sereno	False
interesada	False
acumulado	True
dominantes	False
falsedad	False
movilizaciones	False
verificar	True
honestidad	True
prenda	True
conformación	False
usaba	False
cautela	False
voluntario	True
simbólica	False
dormida	False
encarga	False
compone	False
chorro	False
descomposición	True
lomo	False
viceversa	False
pecados	True
concha	True
andaluza	False
callado	False
camioneta	True
agresivo	True
trágica	True
contrarios	False
inventar	True
mapas	False
iniciarse	False
prisionero	True
pasara	False
auxiliar	False
abanico	False
generosa	True
atractivos	False
ave	True
vocero	False
biología	True
electo	True
salvajes	True
formaron	False
escándalos	False
nutrición	True
carcajada	False
directas	False
polémico	False
molécula	False
milagros	False
despidió	False
opresión	True
imaginaba	False
revelar	False
comporta	False
defendido	True
cantabria	False
artísticos	False
filosófico	True
instalada	False
superan	False
curas	False
sincero	True
inmediaciones	False
difunto	True
velo	True
encierro	False
millas	False
linda	False
separan	False
volverse	False
reinado	False
incumplimiento	True
oficios	False
leves	False
ideológicas	False
mixta	False
nutrientes	True
eguren	False
transferencias	False
recupera	False
realizador	False
paradigma	True
contenía	False
ganan	False
saludable	True
puntualizó	False
consorcio	True
aislada	True
diversión	True
refuerzo	False
fortalecimiento	True
saltos	False
jaula	False
contratado	False
mezclar	True
silencioso	False
rendimientos	False
párrafos	False
deficiencia	True
tele	False
helicópteros	False
saludar	True
sagrada	False
incipiente	False
reivindicación	False
arrastra	False
dominado	False
cañón	True
favoritos	False
franquista	True
convertida	False
pastor	True
patricio	False
productivos	False
fallas	False
inicios	False
contraloría	False
difundir	True
sequía	True
etiqueta	True
adelantar	True
resiste	False
show	True
metabolismo	True
extraordinariamente	False
mataron	False
afectó	False
campanas	False
ambigüedad	True
adoptó	False
registrar	True
soberano	True
comiendo	False
concebir	True
opuesta	False
bulto	False
ideologías	False
kid	False
convierta	False
situó	False
súbita	False
irreversible	True
influye	False
promotores	True
emitió	False
brinda	False
fray	False
atributos	True
vendió	False
misterios	False
arterial	True
aprendió	False
sandinista	True
diversa	False
petrolera	True
sufriendo	False
tribu	False
cónsul	True
contracción	False
rigidez	True
equivalentes	False
alfombra	True
sartén	True
itinerario	True
obligan	False
adjunto	True
protege	False
redondo	False
amistades	False
licitación	True
arrancó	False
banqueros	False
sirvieron	False
desigualdad	True
reconocidos	False
tomará	False
aliviar	True
editoriales	False
indudablemente	False
adjudicación	False
novios	True
atendiendo	False
guantes	True
funcionales	False
larra	False
compadre	False
casó	False
asistente	True
asistido	False
