word	group_known
años	True
vida	False
país	False
año	False
mundo	True
presidente	True
caso	False
forma	True
millones	True
hombre	False
nacional	False
política	True
partido	True
grupo	True
frente	True
personas	False
mujer	False
ciudad	True
social	False
sistema	True
historia	True
punto	True
noche	True
situación	False
tipo	False
agua	True
países	False
ley	True
proceso	True
mano	True
cambio	False
importante	False
realidad	True
desarrollo	False
sociedad	False
centro	True
número	True
cuerpo	True
gente	False
siglo	False
guerra	False
obra	True
padre	True
ojos	True
don	False
pueblo	True
muerte	True
público	False
problemas	False
mañana	True
madre	True
nombre	True
meses	False
hombres	False
derecho	False
problema	True
cabeza	True
hora	False
ministro	False
información	True
señor	False
mujeres	True
tierra	True
director	False
pesetas	False
manos	True
llegar	False
cosa	False
familia	False
equipo	True
casos	False
falta	False
seguridad	True
nivel	True
voz	True
iba	False
semana	False
mayoría	True
español	True
luz	False
orden	True
político	True
proyecto	True
mercado	True
internacional	False
paso	False
empresa	True
policía	True
palabras	True
fuerza	True
puesto	True
puerta	True
comisión	True
programa	False
española	False
real	False
único	False
acción	True
libro	True
interior	False
condiciones	True
calle	False
obras	True
capital	True
música	True
dios	True
fondo	False
persona	True
dinero	True
hijo	False
zona	False
tema	True
razón	False
camino	False
papel	True
vista	False
hablar	False
presencia	True
libertad	True
especial	False
actual	False
relaciones	False
servicio	True
campo	False
relación	True
minutos	False
medios	True
producción	True
movimiento	True
idea	True
julio	True
miembros	True
interés	False
alto	True
principio	False
dirección	True
arte	True
cultura	True
empresas	False
hacía	True
visto	True
puntos	False
mes	False
sector	False
población	True
difícil	False
fuerzas	False
grupos	False
imagen	True
figura	False
futuro	True
militar	True
servicios	False
espacio	True
posibilidad	False
niños	False
económica	False
economía	False
personal	False
jefe	True
carácter	False
organización	True
central	False
actividad	False
aire	True
banco	False
prensa	True
popular	False
necesario	False
justicia	True
joven	True
comunidad	False
edad	True
políticos	True
efecto	True
pública	False
cara	True
crisis	True
decisión	True
necesidad	True
duda	True
capacidad	True
estudio	False
dólares	False
ministerio	True
defensa	False
mundial	False
televisión	False
serie	True
quiero	False
sociales	True
datos	True
base	True
investigación	True
época	False
control	False
queda	True
hijos	False
pasar	False
civil	False
salud	True
paz	True
juego	True
presente	False
niño	True
resultados	False
educación	True
derechos	False
resultado	True
conjunto	True
recursos	True
atención	False
allá	False
izquierda	True
partidos	False
importancia	True
contrario	False
menor	True
pasa	True
resto	False
gracias	True
administración	False
palabra	False
seguir	False
salir	False
fuerte	False
causa	False
calidad	True
medida	True
elecciones	True
secretario	False
silencio	False
comunicación	True
libre	False
fuentes	False
parecía	False
oficial	False
cine	True
mesa	True
cabo	False
españoles	False
naturaleza	True
apoyo	False
importantes	False
común	False
económico	False
principal	False
sol	True
decía	False
energía	True
mar	True
clase	True
dejar	False
especialmente	False
experiencia	True
cantidad	False
jóvenes	False
objeto	False
rey	False
opinión	True
función	True
estudios	False
superior	False
posición	False
única	False
reunión	True
color	False
respuesta	True
trabajadores	True
radio	False
viejo	False
alta	True
sangre	True
evitar	False
elementos	True
resulta	False
partes	False
pensar	False
suelo	True
lucha	True
actividades	True
origen	True
ejército	True
boca	True
medidas	False
cargo	True
américa	True
tomar	False
autoridades	True
autor	True
hechos	True
precisamente	False
pie	False
existencia	True
ayuda	False
productos	False
régimen	False
objetivo	True
teatro	True
políticas	True
sabía	True
línea	False
quería	True
crecimiento	True
acciones	False
encuentro	True
muestra	True
natural	True
compañía	False
derecha	True
carta	False
seguro	False
momentos	False
amigos	True
artículo	True
acto	False
doctor	True
amigo	False
viene	False
formas	False
consecuencia	True
región	False
cuarto	False
ve	False
campaña	True
diario	False
norte	True
metros	True
argentina	True
deja	False
éxito	True
ambiente	True
tiempos	False
actitud	True
escuela	True
especie	True
participación	False
domingo	True
formación	True
finalmente	False
permite	False
blanco	True
marcha	False
baja	False
río	False
principales	False
espera	True
mitad	True
juez	True
sur	True
entrada	False
grande	True
cuadro	False
vivir	False
miedo	True
cambios	True
enfermedad	True
valores	True
llegado	False
mayo	True
estructura	False
negro	True
acerca	False
mira	False
ideas	False
expresión	True
santa	True
construcción	True
análisis	True
peso	False
padres	False
fácil	False
conocimiento	True
pequeño	False
tratamiento	False
democracia	False
materia	False
humanos	False
corazón	True
fecha	True
mayores	True
cuestión	False
unidad	False
diferencia	True
plazo	True
vino	True
período	False
llega	False
texto	False
efectos	False
señora	False
práctica	True
volvió	False
informe	True
puerto	True
cultural	False
socialista	False
oposición	False
carrera	False
tribunal	False
industria	True
pese	False
médico	True
volver	False
asunto	True
mirada	False
exterior	True
llamado	False
favor	False
produce	True
libros	False
enero	True
conciencia	False
atrás	True
mantener	True
cámara	True
modelo	True
electoral	True
sectores	True
diciembre	True
fuego	False
distintos	False
intereses	True
salida	False
técnica	True
ocasión	False
fiscal	True
mejores	False
comercio	True
creación	True
solución	True
vuelta	False
entrar	False
suerte	False
razones	False
aumento	False
pasó	True
principios	True
militares	False
sala	False
humano	True
ocasiones	False
revolución	True
reforma	False
precio	True
características	True
voluntad	True
aspectos	False
recuerdo	False
puso	True
capaz	False
juicio	False
encontrar	True
película	True
programas	True
zonas	False
hija	False
asimismo	False
memoria	True
prueba	False
primeras	False
junio	True
sueño	True
contenido	True
operación	True
título	True
octubre	True
cama	True
toma	False
fútbol	True
posibilidades	True
esfuerzo	False
asociación	True
temas	True
particular	True
producto	False
aspecto	False
vio	False
muerto	False
marco	False
local	False
etapa	False
pequeña	True
corte	True
profesional	False
violencia	True
armas	True
dolor	False
pone	False
ciencia	True
precios	False
presenta	True
llama	True
centros	True
pregunta	False
generales	True
jamás	False
visita	True
victoria	True
suficiente	True
semanas	True
vía	False
riesgo	False
propuesta	True
vuelve	True
busca	False
consumo	True
aparece	True
área	True
siguientes	True
grado	False
tipos	False
encuentran	True
estilo	False
concepto	False
instituciones	True
cielo	False
carne	True
instituto	True
larga	True
material	True
perdido	True
comenzó	False
deseo	True
hermano	True
lenguaje	True
dije	False
cree	False
líder	True
oro	True
humana	False
abril	False
términos	False
buscar	False
simple	True
podido	False
imposible	False
marzo	True
ido	True
conocido	False
septiembre	True
rostro	True
anteriores	True
curso	False
destino	True
nacionales	False
nación	False
motivo	False
piel	True
departamento	False
grave	True
francés	True
condición	True
asuntos	False
preguntó	False
trabajos	False
tercer	True
terreno	False
obtener	False
club	True
responsabilidad	True
hospital	True
ejecutivo	False
comité	False
capítulo	True
noviembre	False
palacio	True
escrito	False
daba	False
doña	False
digo	False
movimientos	False
término	False
máximo	False
propiedad	True
lengua	False
niveles	True
industrial	False
organismo	False
doble	False
ocurre	False
proyectos	True
distancia	True
contacto	True
ejercicio	True
peligro	True
calles	False
oportunidad	True
leyes	True
novela	True
significa	False
ciudades	False
funciones	True
animales	False
presión	True
altura	True
gusta	False
selección	True
gusto	False
teoría	True
isla	True
espíritu	False
lunes	True
pensamiento	False
alma	True
imágenes	True
aplicación	True
verano	True
esperar	False
paciente	True
agosto	False
lograr	False
dejado	True
guardia	False
exposición	False
lugares	True
hotel	False
par	True
crear	False
lista	False
factores	False
sistemas	True
pueblos	True
tratado	False
ciudadanos	True
declaraciones	True
sitio	False
realmente	False
pies	False
dirigentes	False
demanda	False
directamente	False
maestro	False
viernes	True
clara	False
confianza	True
brazos	True
funcionarios	True
sale	True
llamada	False
marido	True
frecuencia	True
moral	True
pequeños	False
diputados	True
totalmente	False
visión	False
intervención	True
normal	True
pobre	False
supone	True
municipal	False
finales	True
kilómetros	False
jugadores	False
objetivos	True
perder	False
esposa	False
fuente	False
enorme	False
discurso	False
pena	False
judicial	True
acceso	False
necesidades	True
protección	False
procesos	False
circunstancias	True
entender	True
conflicto	True
pesos	False
presidencia	False
febrero	True
oficiales	False
páginas	False
representantes	True
temporada	False
públicas	False
pacientes	True
flores	False
evolución	False
técnico	False
pan	True
mala	True
salió	False
red	True
fundamental	False
superficie	False
escena	True
golpe	True
profesionales	True
alcalde	False
teléfono	False
café	True
propósito	True
candidato	True
gesto	False
líneas	False
gestión	True
contar	False
venta	False
ofrece	False
física	True
abajo	True
coche	False
diferencias	False
inversión	False
diálogo	True
calor	True
mamá	False
tarea	True
clases	False
constituye	False
personajes	True
casas	True
territorio	True
responsable	True
llevó	True
documento	True
cambiar	False
europeo	False
tono	True
internacionales	True
aguas	False
europea	True
pintura	True
intención	False
establecer	False
alcanzar	True
públicos	False
respeto	False
frío	True
influencia	True
pasos	True
literatura	False
fenómeno	False
nombres	False
asamblea	True
autores	False
ayuntamiento	True
comercial	True
dando	False
ritmo	True
pruebas	False
fines	True
estudiantes	True
necesita	False
audiencia	False
locales	False
técnicas	False
crítica	False
señala	False
conducta	False
ganar	False
afirma	False
actualidad	False
familiar	True
normas	True
triunfo	False
cumplir	False
empezó	False
leche	True
sábado	False
blanca	False
cabe	True
representación	True
labor	False
equipos	False
refiere	False
sensación	False
tradición	False
jugar	False
muertos	True
compañeros	True
sujeto	True
periódico	True
parecer	False
mantiene	False
competencia	False
profesor	True
alimentos	True
consecuencias	False
declaración	True
objetos	True
vecinos	True
pagar	True
mensaje	False
debate	True
iban	True
comer	False
referencia	True
quieren	False
hacerse	True
vi	False
declaró	False
pidió	False
definitiva	True
edificio	True
jornada	False
dicha	True
fondos	True
médicos	False
dificultades	False
simplemente	False
actos	False
aceite	True
vive	True
fig	False
plano	False
plantas	True
justo	True
posibles	True
representa	True
noticia	True
franco	False
prácticamente	False
versión	False
evidente	True
actuación	False
quedado	False
inmediato	False
miembro	True
tratar	False
suele	True
recién	True
niña	True
caer	False
ámbito	True
habitantes	True
llevaba	False
materiales	False
ausencia	True
fiesta	True
colegio	True
naciones	False
instante	False
brazo	True
áreas	True
corresponde	True
económicos	False
situaciones	False
escribir	True
llegada	False
ven	False
recibió	True
madera	True
federal	True
pleno	False
haga	False
ministros	False
pérdida	False
nota	False
museo	True
fase	False
provincia	True
velocidad	True
veía	True
institución	True
puertas	False
agentes	False
dispuesto	False
recibir	True
tamaño	False
tierras	True
transporte	True
próxima	True
decidió	True
habitación	False
tío	False
revista	False
explica	False
comunidades	False
autoridad	True
socialistas	True
década	True
personaje	True
escenario	False
corriente	False
mínimo	False
independencia	True
abierto	False
histórico	False
viento	True
escritor	True
presupuesto	True
convertido	False
organizaciones	True
tendencia	False
votos	False
secreto	False
acaba	True
anunció	False
produjo	False
operaciones	False
probablemente	False
familiares	False
alumnos	False
pelo	True
periodistas	True
conoce	False
esperanza	True
martes	True
vieja	False
antiguo	False
quiso	False
familias	True
posteriormente	False
reciente	True
división	True
cocina	True
pretende	False
entrevista	False
siguen	False
igualmente	False
piernas	False
reina	True
planta	True
identidad	False
aparte	False
completo	True
comienza	False
hacienda	False
comida	True
rato	False
alemán	True
presentó	False
naturales	True
verde	False
error	True
especies	False
barrio	True
piso	True
volumen	True
hojas	False
piensa	False
recordar	False
comportamiento	False
disposición	True
estrategia	False
necesaria	False
funcionamiento	True
compromiso	True
juegos	False
reacción	True
económicas	False
aparición	True
ingresos	True
abogado	True
oficina	True
consiste	True
parecen	True
cuidado	False
sentía	False
colores	True
soldados	False
recibido	False
elección	True
cárcel	True
pago	False
pequeñas	False
decisiones	False
piedra	True
incremento	False
liga	True
entra	False
distribución	True
suma	True
edición	False
trataba	False
procedimiento	True
iniciativa	True
logró	True
darle	False
poeta	False
cadena	False
sede	True
plata	True
jueves	True
utilizar	False
portavoz	False
similar	False
querido	False
ventana	False
quieres	False
deuda	True
regional	False
animal	False
canal	True
norteamericano	False
continuación	True
medicina	True
inglés	True
venido	True
privada	False
personalidad	True
federación	False
bienes	True
altos	False
parque	True
ataque	True
fe	False
abierta	True
preciso	False
tradicional	False
investigaciones	False
regiones	False
entidad	False
directa	False
enfermedades	True
firma	False
siglos	False
hermanos	True
seres	True
responsables	False
filosofía	True
sirve	False
temperatura	False
presentar	False
ropa	True
elemento	False
sombra	True
alianza	True
decidido	False
carga	False
extranjeros	True
santo	False
luna	True
causas	True
empresarios	True
figuras	True
permanente	False
método	True
huelga	True
marca	False
leer	True
oferta	True
margen	False
presentación	False
azul	True
noticias	True
acaso	False
acuerdos	True
búsqueda	True
tomó	False
constitucional	False
concepción	False
gobernador	True
aparecen	False
juntos	True
cuello	True
puestos	False
pobres	False
constante	True
bancos	True
resolver	False
quedan	False
comienzo	False
labios	True
contrato	True
hermana	True
abrir	False
logrado	False
matrimonio	True
frase	True
llegaron	True
hará	True
importa	False
morir	False
sorpresa	False
documentos	True
caja	True
gastos	True
generalmente	False
extremo	False
caída	True
pareja	False
bolsa	True
encontraba	False
masa	False
previsto	False
titular	False
clave	False
dormir	False
reducción	True
culpa	False
producido	False
menores	True
preocupación	True
terminar	False
miércoles	True
considerar	True
esfuerzos	False
preguntas	True
espectáculo	True
colaboración	True
mente	False
crédito	False
original	True
bases	False
feliz	False
democrática	False
hablando	False
negocio	False
llevado	False
oído	True
diputado	True
decreto	True
europeos	True
tecnología	False
plena	True
cartas	False
películas	True
detalles	True
sentir	False
sacar	False
dirigente	False
veo	True
graves	False
únicamente	False
vas	True
entrega	True
miró	True
corto	True
artista	True
vuelto	False
límites	True
impresión	True
negociaciones	False
caballo	True
planes	False
juventud	False
piezas	False
seguía	False
carretera	True
noches	False
negocios	True
mejorar	False
exteriores	False
inmediatamente	False
encontró	False
correspondiente	False
producir	False
técnicos	True
género	True
voto	False
serio	False
privado	False
actuales	False
equilibrio	True
indica	False
beneficios	True
artistas	True
llamar	False
salón	False
periodista	True
aceptar	False
ocurrido	False
perfectamente	False
integración	False
realiza	True
ocurrió	False
pienso	False
cifra	False
siento	False
misión	False
recuperación	True
explicar	False
respondió	True
vivo	False
unidades	False
conversación	False
cuerpos	False
generación	False
incluye	False
sonrisa	True
espalda	True
rojo	True
criterios	True
claramente	False
individuo	True
china	True
negra	False
cuentas	True
asegura	True
patria	False
corrupción	True
belleza	False
prisión	True
interna	False
pareció	True
pecho	True
habitual	False
papá	False
antigua	False
actor	True
comunista	False
víctimas	True
legal	False
segundos	False
establece	False
duro	True
tráfico	True
pacto	False
comprender	False
extranjero	False
requiere	False
dedos	True
azúcar	True
depende	False
fuertes	False
agencia	True
temor	False
interesante	True
campos	False
absoluta	False
físico	True
venía	True
realización	False
creer	False
gobiernos	False
jugador	False
especiales	False
organismos	False
resistencia	True
coronel	False
concentración	True
reconocimiento	False
negociación	True
aparato	False
universal	True
voces	False
perspectiva	False
pedir	True
recuerda	True
rápido	True
motivos	False
diciendo	False
alegría	True
lleno	False
murió	False
independiente	True
factor	False
sexual	True
sonido	True
estudiar	False
posiciones	False
espacios	True
histórica	True
mercados	True
cuadros	False
producen	False
poesía	True
musical	False
participar	True
vacío	True
lectura	True
seguramente	False
cuestiones	False
constituyen	True
banda	True
clima	True
inicial	False
democrático	False
inferior	True
dudas	True
publicidad	True
mirar	False
intelectual	False
vehículos	False
olvidar	False
actuar	False
alcance	False
partida	False
reconocer	False
papeles	True
capitán	False
sucede	False
latina	True
amplio	False
sexo	True
criterio	False
ganado	False
recurso	False
llevan	True
sesión	False
cooperación	True
laboral	True
compra	False
enseñanza	True
utilización	False
categoría	True
apertura	False
presentan	False
abrió	True
abre	False
solidaridad	True
amplia	False
francesa	False
numerosos	False
encontrado	False
empieza	True
lluvia	True
cifras	False
científico	True
ciencias	False
pide	False
directo	False
mostró	False
interpretación	True
forman	True
quedaba	True
formar	False
extraño	False
síntomas	True
punta	False
conseguido	True
determinado	False
liberación	True
sección	False
tensión	False
presentado	False
escala	False
conde	True
árboles	True
suelen	True
alcohol	True
culturales	False
hacían	True
seguido	False
posterior	False
llena	False
supo	False
empleados	True
ojo	True
dura	True
pasando	True
contexto	True
viejos	False
llamó	True
puesta	False
venir	False
inversiones	True
personales	False
presentes	False
instrumento	True
propuestas	True
máxima	False
populares	True
representante	True
células	True
hambre	True
artículos	False
científicos	True
elaboración	False
continuar	True
vicepresidente	True
esperaba	False
tía	True
significado	True
ventaja	True
quedar	False
resolución	False
pausa	True
basta	False
pensando	False
sindicatos	True
alternativa	False
amenaza	False
conversaciones	False
ruido	True
paro	False
jardín	True
código	False
convertirse	False
distinto	False
intensidad	True
madrugada	False
raíz	True
rápidamente	False
reales	False
pensó	False
métodos	True
servir	False
reducir	False
delito	True
completa	True
entró	True
batalla	False
sentencia	True
entorno	False
sociedades	False
negros	True
cita	True
instrumentos	True
semejante	False
españolas	False
vestido	True
turismo	True
construir	True
instalaciones	True
continúa	False
títulos	True
avión	True
comerciales	False
beneficio	True
norteamericana	False
mexicano	True
tasa	False
absoluto	False
candidatos	False
enfermo	False
dominio	False
excepción	False
órdenes	True
nuevamente	False
asesinato	True
pensaba	False
siguió	True
posee	False
completamente	False
escuchar	True
profunda	True
paredes	False
recientemente	False
manifestaciones	True
mirando	False
perdió	False
despacho	True
hablaba	False
ingreso	True
fórmula	False
empezar	False
inicio	True
múltiples	False
seguida	False
víctima	True
llegan	True
recordó	False
vehículo	False
sentimiento	False
mezcla	True
geografía	True
periodo	False
denuncia	True
moda	True
festival	True
vienen	False
espejo	True
pieza	False
expertos	True
convierte	False
comprar	True
drogas	True
príncipe	True
pared	True
dejando	False
registro	True
porcentaje	True
accidente	False
caliente	False
buscando	True
darse	False
ciclo	True
superiores	True
secretaría	True
capaces	False
nacido	False
argentino	False
muchacho	True
inició	False
di	False
lector	False
viva	False
postura	True
explicación	False
conviene	True
ganas	False
funcionario	True
profundo	False
críticas	False
honor	False
ideal	False
triste	False
placer	True
impuestos	True
sentimientos	True
altas	True
dientes	True
textos	False
acontecimientos	False
mecanismos	False
aumentar	False
composición	True
totalidad	True
foto	False
gas	False
comunes	False
tomado	False
agricultura	True
individuos	False
inteligencia	False
modelos	True
baño	True
considerado	True
opción	False
olor	False
índice	True
ganó	True
desarrollar	False
experiencias	False
cerebro	True
exige	False
horno	True
preparación	False
individual	False
moderna	False
habló	False
errores	False
estatal	True
haberse	False
depresión	False
armadas	False
policías	True
señalar	True
estructuras	False
entidades	False
italiano	True
consideran	True
esencial	True
firme	True
global	False
disco	True
supremo	False
absolutamente	False
cargos	False
fotografía	True
distinta	False
polvo	True
humor	False
pintor	True
conceptos	False
vasco	True
naturalmente	False
fracaso	True
recibe	False
complejo	True
acabar	False
abandonar	False
fundamentales	False
creciente	False
restos	True
conocida	True
terminó	False
minuto	True
excelente	True
regreso	True
página	False
discusión	False
déficit	True
ánimo	True
vale	False
reyes	True
numerosas	True
detenido	True
localidad	False
diseño	True
sintió	False
cumbre	False
sueños	True
impuesto	True
fundamentalmente	False
deporte	True
gloria	False
universo	False
convenio	False
pasión	False
jueces	True
luces	False
protesta	True
periódicos	True
estrellas	False
permiten	False
añade	False
definitivamente	False
conocimientos	True
concreto	False
elegido	False
recorrido	False
estación	False
compañero	False
lógica	True
comunicado	False
derrota	True
cierre	False
viven	True
definición	False
campesinos	True
límite	True
comprobar	False
parecido	False
dosis	True
esperando	False
exclusivamente	False
embajador	True
inflación	True
enemigo	False
interno	False
crimen	False
residencia	True
soledad	True
eficacia	False
respectivamente	False
paisaje	True
oír	False
tareas	True
costumbre	True
resultó	False
interesa	False
impacto	True
conocía	False
pasaba	False
estadounidense	False
religión	True
profesores	True
autonomía	True
exactamente	True
componentes	True
cayó	False
norteamericanos	False
asistencia	True
cambiado	False
probable	False
caminos	True
científica	True
duración	True
vías	True
manifestación	True
convirtió	False
malo	True
antiguos	False
obligado	False
enfermos	False
oscuro	False
pura	True
vaso	False
ofrecer	False
marcos	False
petróleo	True
reglas	True
invierno	True
máquina	True
reuniones	True
municipales	True
nacimiento	False
pedido	False
extensión	True
apareció	False
tesis	True
indios	False
vivienda	True
responde	False
pantalla	True
adecuada	False
paseo	False
determinar	False
utiliza	False
toro	False
presidencial	False
implica	True
acabó	True
salido	False
franceses	True
ejecución	True
puro	False
oye	False
consiguió	False
entiende	True
occidental	True
gasto	False
encontramos	False
imperio	True
superar	False
imaginación	True
estabilidad	True
rasgos	True
frontera	True
cubano	True
adecuado	False
gol	True
industriales	False
compañías	True
soluciones	False
catalán	True
marina	False
dificultad	True
trabajando	True
virtud	True
libres	True
observar	False
dirige	False
petición	True
potencia	True
correr	True
anual	False
signo	False
tren	True
órganos	True
propiedades	True
necesarios	False
responder	False
distrito	False
notable	False
clientes	True
mando	True
mecanismo	False
claridad	False
redacción	False
señal	True
actores	True
quiera	False
conclusión	True
ocupa	False
establecido	False
quedaron	False
creado	False
sentado	False
contiene	False
hierro	True
riqueza	True
detalle	False
positivo	False
auto	False
alcanza	False
senado	True
correspondientes	False
frecuente	False
promedio	False
pista	True
piedras	False
amistad	False
puente	True
hogar	True
daño	True
patio	True
otan	True
facultad	False
tropas	False
vuelo	True
demostrar	False
muchacha	False
reflexión	False
consideración	False
editorial	True
tradicionales	True
obligación	True
hipótesis	True
dejan	True
hecha	True
relato	False
llamaba	False
reconoce	False
similares	True
recuperar	True
costo	False
juzgado	False
eficaz	False
pensé	False
orquesta	True
permitió	False
descubrir	False
viviendas	True
gritos	True
poderes	False
ventas	False
fría	False
diagnóstico	True
realizada	True
utilizado	True
silla	True
publicado	True
rechazo	False
prácticas	False
corta	False
loco	True
debo	False
esquema	False
líderes	True
propone	False
desea	False
progreso	True
defender	False
borde	False
remedio	True
transformación	True
ayudar	False
cortes	True
mental	False
verse	False
fortuna	False
aeropuerto	True
escuelas	False
abuela	False
droga	True
levantó	False
exceso	False
disciplina	True
reformas	False
gana	False
delitos	True
difusión	True
hombros	True
elegir	True
tratando	False
planeta	True
mantenimiento	True
civiles	False
hice	False
afecta	False
pierde	False
dimensión	False
ponen	True
pobreza	True
establecimiento	True
prestigio	True
círculo	True
toros	True
transición	False
cumplimiento	False
crea	False
famoso	False
gentes	True
encargado	False
lentamente	False
avenida	False
satisfacción	True
matar	False
pase	False
aplicar	False
viajes	False
dictadura	False
acompañado	True
grados	True
obtuvo	False
colectivo	False
gracia	False
chica	False
indígenas	True
expresa	False
citado	False
cáncer	True
regresar	False
descenso	True
diarios	True
entusiasmo	False
respuestas	True
recuerdos	False
contestó	False
explotación	True
particulares	False
masas	False
manejo	False
sindicato	True
financiero	False
protagonista	False
conflictos	False
aprobación	False
pasan	False
dueño	False
armada	True
telefónica	False
formado	False
sabido	True
dedicado	False
presos	False
controlar	False
consciente	True
liberal	True
conveniente	False
nació	False
dejaba	True
centrales	True
mediados	False
agente	True
montaña	True
publicación	False
cerrar	False
seno	True
dirigido	False
investigadores	False
torneo	False
útil	True
playa	False
lógico	False
subir	False
iniciar	False
escribe	True
golpes	False
próximas	False
terminado	False
universidades	False
revolucionario	False
metro	True
tabla	False
atentado	True
llamadas	False
polémica	False
crítico	False
quisiera	False
particularmente	False
atmósfera	False
descubierto	False
avance	True
evidencia	True
estadio	True
cerrado	False
efectivamente	False
inmediata	False
circulación	False
detenidos	False
dolores	False
apartado	False
anda	False
reconoció	True
muestran	False
dulce	True
escribió	True
terrible	False
permitir	True
campeón	False
gustaría	False
manifiesto	False
asegurar	False
feria	True
trato	False
números	True
edificios	True
extraña	True
determinados	True
señores	True
taza	True
católica	False
fenómenos	True
dada	False
moderno	False
barco	True
ingredientes	True
vender	False
empresario	False
humanidad	True
fácilmente	False
actitudes	False
diga	False
décadas	True
infancia	False
comunicaciones	False
consulta	False
rumbo	False
eléctrica	False
bajar	False
ejemplos	False
blancos	True
legislación	True
llaman	False
ponerse	False
rápida	False
entero	False
rueda	False
mantuvo	True
contó	True
creen	False
campeonato	False
demostrado	False
sustancias	True
necesarias	False
levanta	False
letras	True
andar	False
termina	False
sierra	False
instalación	True
árbol	True
alimentación	True
esquina	False
mexicanos	True
expansión	False
mejora	True
vacaciones	True
alcanzado	False
clasificación	False
reloj	True
huevos	True
banca	False
ciudadano	True
alcanzó	True
raíces	False
deseos	False
impulso	False
comenzar	True
dispone	False
órgano	True
arena	True
opiniones	False
procedimientos	True
maestros	True
anteriormente	False
moneda	True
comandante	True
fiestas	False
viendo	False
creía	False
jefes	False
homenaje	True
cadáver	True
gravedad	True
cantidades	True
siguiendo	False
especialistas	True
informa	False
demuestra	False
advirtió	False
intelectuales	True
signos	True
largas	True
escándalo	True
bajas	True
sensibilidad	True
lágrimas	False
suficientes	False
estancia	True
profundidad	False
argumento	True
comenzaron	False
mostrar	True
tabaco	True
conocidos	True
concurso	False
pertenece	False
largos	False
angustia	True
analizar	True
inicia	False
observa	False
presupuestos	False
tercero	False
aprender	True
dirigida	False
terrorismo	True
llegaba	True
vemos	False
evaluación	True
felicidad	True
socios	False
diría	False
existentes	True
oscuridad	False
manifiesta	True
radical	False
elevado	False
ventajas	False
anuncio	True
arma	True
ceremonia	True
virus	True
colección	False
pude	False
afirmar	False
previamente	False
brillante	False
aparecer	True
comunistas	True
permiso	False
vivido	False
cena	True
dependencia	True
potencial	False
norma	False
ampliación	False
sufrido	False
combate	False
situado	False
cuesta	True
caballos	True
recientes	True
mantienen	False
teniente	True
traje	False
actuaciones	False
impedir	True
proporción	False
corona	True
clásico	False
motor	True
parecían	False
dignidad	True
contenidos	False
dé	False
biblioteca	True
argumentos	False
negativa	True
humo	True
senador	True
corrientes	False
deportivo	False
galería	True
suave	True
colonia	False
concierto	False
rival	False
activa	False
preparado	True
negó	True
escasa	False
continuidad	False
ópera	True
espero	False
toneladas	False
iguales	False
historias	False
decirle	True
definir	False
comisiones	True
aventura	True
comprensión	True
convocatoria	True
artes	False
dedo	False
profesión	True
plantea	False
determinada	False
miraba	False
difíciles	False
provincial	False
canciones	False
oportunidades	False
solar	True
coalición	False
descanso	True
hablado	True
representan	False
promoción	False
reducido	False
aprendizaje	True
cultivo	True
continente	True
chico	False
fechas	False
cubrir	True
síntesis	True
hiciera	True
débil	True
urbano	True
infantil	False
tomando	True
provincias	True
cuentan	False
arquitectura	True
mínima	True
integrantes	True
estrella	False
orientación	True
meta	True
destrucción	False
enemigos	False
pendiente	False
electorales	True
primavera	True
automóvil	False
confusión	False
productores	True
vidas	False
tocar	False
ricos	True
financiación	False
panorama	False
ofreció	False
proteínas	True
permitido	False
abuelo	True
británico	True
relativamente	False
vital	False
sufrir	False
dispuestos	True
celebración	False
eje	True
frecuentes	True
nervioso	False
haría	False
capa	True
atender	False
vivía	False
legales	True
determinadas	True
anoche	False
disminución	False
existir	False
abogados	True
afuera	False
curiosidad	True
variedad	False
mediodía	True
obreros	False
contactos	False
dirigió	True
nariz	True
previa	True
ernesto	False
embajada	False
patrimonio	True
necesitan	True
dejaron	False
afectados	False
reservas	False
créditos	True
sacó	False
romper	False
emoción	True
jurídica	False
risa	True
letra	False
informes	False
oficinas	True
pérdidas	False
vueltas	True
desaparición	True
bandera	True
consejero	False
jurídico	True
formal	False
llamados	False
gira	False
castellano	False
conforme	True
comentarios	False
mexicana	True
acusado	False
notas	True
heridos	False
aumenta	False
utilizan	False
externa	True
reserva	False
responsabilidades	False
pensado	False
núcleo	True
programación	False
sencillo	False
riesgos	False
observación	True
religiosa	True
colectiva	False
cae	False
facilidad	True
amiga	False
frases	False
regular	False
logra	False
dioses	False
símbolo	False
destaca	True
característica	True
mensajes	False
quedarse	False
mandato	False
vivos	True
suficientemente	False
ilusión	True
consenso	False
necesariamente	False
malos	False
cura	False
acababa	False
intentó	True
dimensiones	True
asumir	True
circunstancia	False
fama	False
inútil	False
emperador	True
desaparecido	True
tiro	False
canción	True
venga	True
verdes	True
harina	True
básicos	False
testigos	False
sombras	False
fruto	True
bar	True
espectadores	True
igualdad	True
costumbres	False
relacionados	False
sabor	True
oeste	True
llevaron	True
precisa	False
posesión	True
delegación	False
tasas	False
sostiene	False
ofrecen	True
privadas	True
huesos	True
decidir	False
plato	True
permita	True
setenta	True
ponía	False
hoja	False
convencido	False
reglamento	True
ves	True
vigor	False
financieros	True
aviones	True
insistió	False
lujo	True
policial	True
segura	False
columna	True
ataques	False
corresponsal	True
escritores	True
ramas	True
ácido	True
percepción	True
incluyendo	False
león	True
merece	False
perros	True
presiones	False
destacar	True
provocar	False
beber	True
rigor	False
obtenido	False
mueve	True
plazas	False
etapas	True
dato	False
contratos	True
vigilancia	False
dará	False
sucedido	True
temporal	False
utilizando	True
esencia	True
toca	False
secretos	False
eliminar	True
botella	False
guerrilla	True
grito	False
torre	True
kilos	True
fotografías	False
desarrolla	False
tranquilo	False
monte	False
sujetos	False
caído	False
detuvo	False
daños	False
idioma	True
preparar	True
alemanes	True
dieta	True
añadir	False
firmado	True
perfecto	False
europeas	True
vieron	False
muestras	False
renuncia	True
narcotráfico	False
ordenó	False
favorable	True
rendimiento	True
xx	False
artística	False
dinámica	True
líquido	False
financiera	False
obliga	False
siquiera	False
clínica	False
conclusiones	False
reacciones	False
deber	True
turno	False
terrenos	True
realizan	False
provoca	True
exigencias	False
calma	True
sentirse	False
garantizar	False
llorar	True
intercambio	True
conservación	True
autónoma	False
blancas	True
levantar	True
desarrollado	False
intensa	False
disposiciones	False
enviado	False
salía	True
odio	True
pescado	False
fiscales	True
olvidado	False
examen	False
existía	False
americano	True
vecino	False
opciones	False
roja	False
multitud	False
zapatos	False
precisión	False
cuarta	True
canto	False
usuarios	True
desconocido	False
coches	False
gustaba	False
seco	False
unidas	True
daban	False
imprescindible	False
revisión	True
asociaciones	True
salarios	False
destacó	False
realizadas	False
baile	True
chicos	False
privados	True
entrenador	True
organizado	False
salto	True
orgullo	True
positiva	True
verdaderamente	False
conocen	True
estima	False
contaba	False
raro	False
materias	False
sufrió	False
emisión	True
carreras	False
testigo	True
cristal	False
profundamente	False
retrato	True
danza	True
existente	False
curioso	False
revistas	True
ética	False
ideología	True
ruptura	False
identificación	False
informaciones	False
lento	False
suponer	False
castigo	False
ruta	True
cursos	True
hombro	True
tel	False
goles	False
cumple	False
colocar	True
exportaciones	True
deportes	False
sirven	True
separación	False
nuclear	False
confirmó	False
perfil	False
estética	True
misterio	False
apariencia	True
seguros	False
irse	False
adquirir	True
femenina	False
respaldo	False
península	True
modificaciones	False
procedentes	False
horizonte	True
surge	True
bienestar	False
invitados	True
imaginar	False
uniforme	True
aparentemente	False
condena	False
detención	True
asiento	True
individuales	False
camisa	False
tragedia	True
temperaturas	True
muchachos	True
señales	True
fronteras	False
sienta	True
alternativas	False
hagan	False
santos	False
tendencias	True
comparación	True
bomba	False
expectativas	False
tve	False
rodillas	False
unida	False
testimonio	False
montañas	False
desgracia	True
alemana	False
acercó	True
salen	False
cometido	False
trató	False
publicó	False
participantes	True
ciertamente	False
ventanas	True
caminar	True
encontrarse	True
terroristas	True
institucional	False
templo	True
contaminación	False
bajos	False
clásica	True
escalera	True
médica	False
cercano	False
sustancia	True
protagonistas	False
religioso	True
visitar	True
paquete	True
demandas	False
enormes	False
ligeramente	False
sufre	True
humedad	True
juega	False
heridas	False
recoger	False
candidatura	False
actúa	False
queso	True
ejemplares	False
laboratorio	True
permanecer	False
tienda	True
auténtico	False
claras	False
cantante	True
definitivo	False
tristeza	True
lados	False
bloque	False
parlamentarios	False
obispo	True
concesión	False
vergüenza	True
aprobado	True
defensor	True
enfrentamiento	False
solicitud	True
socialismo	True
refleja	False
halla	True
trayectoria	True
espaldas	True
secuestro	True
ayudas	False
diablo	False
luchar	False
sindical	True
salvar	False
inevitable	False
cebolla	True
cumplido	True
recoge	False
suspensión	True
ocupar	False
capitales	True
tiende	False
alza	False
gris	False
descripción	False
finalidad	False
dólar	True
comienzos	True
actriz	True
peligroso	False
gestos	False
coste	True
garantía	False
auténtica	False
entera	False
alimento	True
femenino	False
verlo	False
cola	True
echar	False
posiblemente	False
amparo	True
prima	False
provocado	False
maíz	True
reflejo	True
asistir	False
mantenido	True
hilo	True
previo	False
impide	False
infraestructura	False
urgencia	True
tranquilidad	True
xviii	True
intenso	False
poblaciones	False
facilitar	True
inmensa	False
nieve	True
intenciones	False
islas	True
conozco	False
presidentes	False
permitirá	False
terror	False
corre	False
ap	False
hacerle	False
provocó	True
fiel	False
destinado	False
afirmación	False
tejido	True
bolsillo	True
acudir	False
incorporación	False
antecedentes	False
extremos	True
amante	True
municipio	True
supongo	False
negociar	False
bosques	True
vocación	False
normalmente	False
piano	True
llegue	True
instrucciones	False
cerró	True
huevo	True
intentos	False
cubanos	False
granada	False
comprende	True
decían	True
espectador	True
cabezas	False
señalado	True
cámaras	True
pasajeros	True
balance	False
sindicales	False
viejas	False
conduce	False
fábrica	True
plenamente	False
domicilio	False
aceptación	True
relativa	False
instancia	False
vigente	False
km	True
ensayo	True
lectores	True
necesitaba	True
terrorista	True
regionales	False
corresponden	False
cubierta	True
dichos	False
iniciado	True
extrema	False
competencias	False
ejercer	False
adiós	True
accidentes	True
humanas	False
irán	False
obligaciones	True
acusaciones	True
oriente	True
mentira	True
rico	True
caras	True
tela	True
fija	False
votación	False
específico	False
pasaron	True
negativo	True
leído	True
cadenas	False
quede	True
emergencia	False
subida	False
compromisos	True
canales	True
premios	True
cerrada	True
incluido	False
comentario	False
quinto	False
singular	True
avances	True
pelota	True
teorías	True
regla	False
pierna	False
parar	False
entrado	False
compuesto	True
concluyó	True
convivencia	True
posteriores	False
corriendo	True
decirse	False
poniendo	False
guía	True
ansiedad	True
empresarial	False
inteligente	False
hermosa	False
propuso	False
volvía	True
continuó	False
generaciones	False
independientes	False
empezaron	False
agrega	False
resultaba	False
comenzado	True
amenazas	True
gubernamental	False
épocas	True
acceder	True
encontraban	True
olvido	True
conoció	False
cambia	False
talento	True
evidentemente	False
empleado	True
rural	True
ambiental	True
entregó	True
efectivo	False
sirvió	False
esperan	False
vanguardia	False
aprovechar	False
cm	True
críticos	False
considerable	False
cero	True
ocurrir	True
desierto	True
músculos	True
literaria	False
exilio	True
escrita	False
explicaciones	True
propuesto	False
nubes	True
funciona	False
colombiano	True
espiritual	True
encontraron	True
entiendo	False
repetir	False
descubrió	False
pusieron	True
adaptación	True
espectacular	False
ríos	True
condenado	True
fotos	False
azules	False
encuentros	False
contraste	True
simples	False
adentro	False
cliente	True
desempleo	True
italiana	True
dices	False
sesiones	False
planos	True
escolar	True
liberales	True
adultos	False
izquierdo	False
extraordinaria	False
salsa	True
advierte	False
tarjeta	True
represión	False
et	False
tesoro	True
locura	False
abundante	False
socio	True
modificar	True
comisario	False
novia	False
caza	True
activo	True
abiertos	True
proyección	False
cubana	False
directores	False
combatir	False
doctrina	True
realizados	True
querían	True
lesiones	False
define	False
distinguir	False
municipios	False
urss	False
abandono	False
adoptar	True
ruso	True
medicamentos	False
explosión	True
renovación	True
perfecta	False
expresar	False
química	True
transmisión	False
modificación	True
concluir	True
pensamientos	True
convertir	False
restantes	False
alteraciones	False
sostuvo	True
trae	True
niega	False
corporación	True
determinación	True
equivalente	False
viviendo	False
internos	False
artístico	False
lanzó	False
urbana	True
rapidez	True
sombrero	True
roca	True
estómago	True
ronda	False
paciencia	False
escapar	False
poema	True
listas	True
apoyar	False
debilidad	True
escritos	False
viajar	True
miseria	False
indispensable	False
visitas	False
otoño	True
plástico	True
ocupación	True
veremos	True
combinación	False
magnitud	False
activos	True
permanece	False
acá	False
ejemplar	False
enfrentar	False
fusión	True
declarar	False
básica	False
cantar	False
limpieza	True
herencia	False
desaparecer	True
poseen	True
pilar	False
extraordinario	False
raza	True
misa	True
cariño	True
resultar	False
aficionados	True
decide	False
culto	False
utilidad	True
deterioro	True
flor	True
escenas	False
sucedió	True
reconocido	True
falso	True
soberanía	True
situada	False
introducir	False
ingeniero	True
efectuar	False
abandonado	False
aniversario	True
filas	True
parlamentario	False
aceptó	True
turistas	True
restaurante	True
incidencia	False
tránsito	False
rojas	True
dibujo	False
vigencia	True
aparente	False
afán	False
retirada	False
frutas	True
documentación	False
parcial	True
prisa	False
pagos	False
denominado	False
trastornos	False
personalmente	False
garantías	True
jurado	True
recurrir	False
incapaz	False
sentí	False
conquista	True
seguirá	False
envió	True
escritura	True
sacrificio	True
tribunales	True
impone	False
saca	False
comando	True
rincón	False
costado	False
concreta	False
sonidos	False
regulación	True
soldado	True
oficialmente	False
acusación	True
infección	True
versiones	False
prevista	False
convicción	True
celebrar	False
sitúa	False
normales	True
perspectivas	True
ucd	False
finanzas	True
anuales	False
introducción	False
sexuales	False
novelas	False
esposo	True
propietarios	False
discutir	False
patrón	True
declarado	False
resultan	False
crees	True
anunciado	False
imponer	True
redes	False
históricos	True
reciben	False
retorno	True
expresiones	False
gerente	True
pistola	True
renta	True
pasillo	False
significativo	True
buscan	False
planificación	False
bruselas	True
versos	False
novedad	False
constantemente	False
máquinas	True
censura	True
sencilla	False
art	False
frutos	False
organizar	False
resumen	True
visitantes	True
policiales	True
planteamiento	True
bella	False
oscura	False
nombrado	False
calificó	False
herido	True
conductor	True
delegado	False
poemas	False
músicos	True
argentinos	True
negras	False
enfoque	False
amarillo	True
caracteriza	False
incluyen	False
corporal	False
considerarse	False
escucha	True
entrenamiento	False
sumamente	False
reparto	False
costos	True
expediente	True
diversidad	True
síndrome	False
colegas	True
gritó	True
continua	True
coordinación	False
cajas	False
acepta	False
ejecutiva	False
balón	True
madres	True
aparatos	False
relieve	False
urgente	False
penas	False
parlamentaria	False
avanzar	True
sitios	False
gramos	False
fresco	False
jugando	False
propietario	True
muebles	True
pendientes	False
espacial	False
despertar	True
carreteras	True
episodio	True
salieron	True
mencionado	False
proteger	True
disponer	False
nacionalistas	True
milagro	True
promover	False
directivos	False
salario	True
limitaciones	False
burguesía	True
efectiva	True
judiciales	False
viuda	True
variable	False
decirlo	False
barrios	True
bellas	False
servido	True
centímetros	False
alturas	False
platos	False
piloto	True
sometido	False
automóviles	False
fiebre	True
únicos	False
llegando	False
británica	False
longitud	True
circular	True
correcta	False
cartera	True
herida	False
echó	True
muerta	True
obtiene	False
ajuste	True
vientre	False
arco	True
formando	False
judíos	True
aprobó	True
grasa	True
semejantes	False
agrícola	False
soportar	False
sensible	False
inferiores	False
basada	False
territorios	True
antiguas	False
cualidades	True
fuga	False
contado	True
musicales	True
estrecha	False
sospecha	False
metido	False
culturas	False
ancho	True
sucesos	False
visible	True
esperanzas	True
adquisición	True
vidrio	True
prepara	False
chileno	False
celebrado	False
preocupa	False
circuito	True
intervenir	False
sorprendente	False
pinturas	True
guardias	True
físicas	False
respiración	True
adn	True
rayos	False
pertenecen	True
elaborado	False
basa	True
oreja	True
ajo	True
barcos	True
mire	False
requisitos	True
ocupado	True
muro	False
integral	False
dichas	True
solitario	False
palma	True
fallo	False
recinto	False
escaso	False
medias	True
poetas	False
culpable	True
agradable	False
piensan	False
directiva	False
consumidores	True
abiertas	True
nombramiento	False
gato	True
indígena	False
fabricación	True
vuelven	True
incluir	False
cambió	True
dibujos	False
empezado	True
marcado	False
señorita	False
contemplar	False
india	False
recordaba	False
xvii	False
comicios	False
coloca	True
crónica	False
autorización	True
rocas	True
laborales	True
malas	True
incendio	True
estable	True
boda	False
traslado	False
embarazo	True
creó	True
caldo	False
dispuesta	False
variables	True
ilegal	False
monarquía	True
denuncias	False
mapa	True
absurdo	True
interesados	False
afectan	False
vientos	True
acontecimiento	True
regalo	True
ordenador	True
estatales	False
ingleses	True
estudiante	True
hábitos	False
perdida	False
conservar	False
famosa	False
continuo	False
hospitales	True
habilidad	True
ahorro	True
básico	False
referencias	True
cintura	True
cotidiana	False
duró	False
presentarse	True
lenguas	True
ejercicios	True
alicia	False
basura	False
hijas	True
fórmulas	False
miel	True
indican	False
trabajador	True
deje	False
acabado	False
cristianos	True
mesas	False
cerveza	True
ampliar	True
aclarar	False
catalana	True
aceptado	True
oriental	False
vivió	True
contempla	False
públicamente	False
esclavos	False
crecer	False
colaboradores	False
prevé	False
infierno	True
interesado	True
afectado	False
verá	True
salas	False
atractivo	False
religiosas	False
presentada	False
relacionadas	True
pecado	True
cigarrillo	True
sillón	False
integrado	False
eliminación	False
juvenil	False
llave	False
revela	False
realizará	False
mostrado	False
campañas	False
encuesta	False
habituales	True
bajó	False
basado	False
té	True
siga	False
poderoso	False
civilización	False
valoración	False
estaciones	True
certeza	False
justamente	False
récord	False
leve	False
incidente	False
transportes	False
esenciales	True
toman	False
refugio	True
limón	False
inquietud	False
impuso	True
consta	True
cierra	True
ajeno	False
regresó	True
específica	False
citada	False
sienten	False
internas	False
tarifas	True
utilizados	False
cálculo	False
lenta	False
faltaba	True
nave	True
oxígeno	True
jornadas	False
habitaciones	False
complejidad	True
dirigir	False
sustitución	True
identificar	False
torres	False
italianos	False
nervios	True
producirse	False
azar	True
guerras	False
militantes	True
futura	False
americanos	False
representar	False
sacerdote	False
construido	True
físicos	True
conexión	True
observaciones	True
recepción	False
guarda	True
cuartos	True
llevando	False
figuran	False
calendario	True
vencer	False
estímulo	False
propaganda	True
concretos	True
exclusiva	False
compartir	False
aliento	False
suiza	True
cercana	False
significación	False
llevaban	True
seca	False
extranjera	False
evento	True
agresión	True
entradas	False
considerada	False
sanciones	False
taller	False
ascenso	True
une	True
maneras	False
guión	False
destinados	True
destacan	True
insiste	False
retraso	False
adolescente	True
árabe	False
leyenda	True
dimisión	False
eco	False
ensayos	True
revés	False
americana	True
admiración	True
variaciones	True
marcas	False
evita	False
hermoso	False
niñas	True
exportación	False
lograron	False
dominante	True
solicitar	False
beso	False
estrictamente	False
plantilla	True
mariana	True
libertades	False
literario	True
pájaros	False
categorías	True
doy	False
disfrutar	True
perfección	False
cancha	False
adquiere	True
excesiva	True
períodos	False
conserva	False
anuncia	False
mierda	False
suprema	False
asistentes	True
entregar	False
crema	False
pregunté	False
específicos	False
investigar	True
personalidades	False
extiende	False
parejas	True
verla	True
dormido	False
denomina	True
creador	True
decenas	True
falsa	False
toque	False
nace	False
carbón	True
catalanes	False
componente	False
rara	True
oyó	False
contribuir	False
suceso	True
cobertura	True
financieras	False
venían	False
cubierto	False
comerciantes	True
consideraba	False
alegre	False
héroe	True
brasileño	False
enviar	True
compositor	True
soporte	True
seria	False
fantasía	False
montaje	False
generar	False
guerrilleros	True
ofensiva	True
racional	False
camión	True
aplica	False
espada	False
celebró	False
obtenidos	True
invasión	True
respectivos	False
puta	False
industrias	False
sucesión	False
visual	True
acumulación	False
afición	True
rica	False
entendido	False
excepcional	False
trimestre	True
facultades	False
aliados	False
armado	False
concretas	False
cuerda	False
justificar	False
muere	False
paga	False
fundamento	False
limpia	False
orilla	False
pensiones	False
correcto	True
consejos	True
sentarse	True
increíble	False
rango	True
inocente	True
presentaron	False
compleja	False
mantenerse	True
relativo	False
genera	False
decidieron	True
cementerio	False
tratados	True
renunciar	True
empezaba	False
reduce	False
irá	True
relacionado	False
genes	True
hielo	True
prevención	True
elevada	False
noble	False
vegetales	False
señalan	False
primaria	True
tecnologías	False
externo	True
sepa	False
transcurso	False
sueldo	False
quedará	False
frecuentemente	False
conocidas	False
rock	True
aviso	False
asalto	True
abandonó	True
delegados	False
decisivo	False
pasados	False
discursos	True
supervivencia	True
duras	False
perdón	False
estadounidenses	False
recibieron	True
orejas	True
invitado	False
emisoras	False
selva	False
satisfacer	False
distinción	True
fases	True
vestidos	False
indicar	True
canciller	True
subió	True
refugiados	True
cortar	True
reto	True
fraude	False
orgánica	False
juntas	False
tocó	False
fiscalía	True
ruedas	False
mito	True
interesantes	False
labores	True
capitalismo	True
sorprendido	False
gubernamentales	True
cansancio	False
inicialmente	False
lejano	False
recorrer	True
sabían	False
bandas	False
normativa	False
rabia	True
reproducción	True
conducir	True
célebre	False
seguimiento	False
roto	False
quedaban	False
proceder	False
rama	True
genética	True
intimidad	False
hechas	True
dedica	False
universitarios	True
cuenca	False
cuadrados	False
solía	False
colombianos	True
administrativa	False
entrevistas	False
armados	True
exigir	True
drama	False
vea	True
requieren	False
caballero	True
coinciden	False
colonial	False
básicamente	False
filme	False
tratan	False
adquirido	False
aves	True
religiosos	True
tensiones	False
densidad	True
carece	False
intérpretes	False
sube	False
clásicos	False
surgió	True
cuartel	True
cuentos	True
apunta	False
hallaba	False
emisora	False
duros	False
comienzan	False
lesión	True
ángulo	True
llamas	False
barro	True
asesinado	False
quedando	False
derivados	True
minerales	True
quinta	True
originales	False
madrileño	True
rumores	True
tramo	False
afrontar	False
muros	False
entendimiento	False
repite	False
básicas	True
barra	False
miradas	True
nacer	False
efectivos	False
tumba	False
extranjeras	True
correo	False
desnudo	True
aseguran	False
hectáreas	False
dedicada	False
pasta	False
simultáneamente	False
iniciativas	True
probar	False
subrayó	True
lanza	True
almuerzo	True
docentes	False
planteamientos	False
bahía	False
cuota	False
inglesa	False
vano	False
educativo	False
horror	True
seguidores	True
publicada	False
rojos	False
permanencia	False
protestas	True
procedente	False
cristiana	True
virtudes	False
piden	True
pelea	False
casado	True
diaria	True
amo	False
metal	True
permitía	True
secuencia	True
fila	False
prd	False
concejal	True
importaciones	False
harán	True
párrafo	False
dormitorio	True
oculta	True
detener	False
carro	True
tiendas	False
admite	False
supuestos	False
aprendido	False
estudia	False
habitualmente	False
curva	True
crece	False
loca	False
incertidumbre	True
magistrado	False
cartel	False
limpio	True
murieron	False
aplicaciones	True
limitado	False
listo	True
dueños	False
apoya	False
estrategias	True
presunto	False
privatización	False
formada	False
elegante	False
tranquila	False
pretendía	True
incluidos	False
and	False
detiene	True
comedor	True
conservador	False
peculiar	False
celebra	False
resultaron	True
procede	False
teatral	False
tronco	True
chino	True
vascos	True
empeño	False
tercio	False
irregularidades	True
precisó	False
lluvias	False
trajo	True
kg	False
vapor	True
monetaria	False
razonable	False
propiamente	False
cristales	False
tejidos	False
corredor	True
exigencia	True
nerviosa	True
promesa	True
quito	True
deseaba	False
costes	True
criminal	True
cinta	False
alumno	False
encuestas	False
conciertos	False
ganador	False
traído	True
especialista	False
cucharada	False
aparecía	False
incapacidad	True
choque	False
garganta	True
invitación	False
venezolano	True
pretenden	False
productividad	True
separado	False
específicas	False
mantenía	False
robo	True
elaborar	False
preguntar	True
arquitecto	True
asombro	False
mentales	False
respetar	False
patas	True
felices	False
bailar	False
mecánica	True
constantes	False
cadáveres	True
unido	False
disminuir	False
bosnia	True
constituido	True
participaron	True
demostró	False
moverse	True
tardes	False
diera	False
hermanas	True
manteca	False
destacado	False
aporte	False
censo	False
adolescentes	False
recta	True
profundas	True
cálculos	True
supuesta	False
comenta	True
aislamiento	True
manolo	False
juzgar	True
acercarse	False
informar	False
jugo	True
estableció	False
huir	False
dama	True
amanecer	False
notar	False
intentando	False
registrado	False
occidentales	True
vayan	False
rostros	False
interpretar	False
satisfecho	True
definido	False
genio	True
notables	False
positivos	False
atlántico	True
tentación	False
entregado	False
secretaria	False
proporciona	False
colegios	True
costas	False
discos	False
informaron	False
enfrenta	False
acusa	True
capítulos	False
mínimos	False
inés	True
celebrada	False
traer	False
israelí	False
pintores	False
clubes	True
provisional	True
entran	False
alarma	True
empate	True
firmas	False
obligados	False
incidentes	True
cuchillo	True
agrícolas	True
trama	False
oral	True
actúan	False
referente	False
instantes	False
giro	False
presa	True
acusados	False
opuesto	False
publicaciones	False
cucharadas	False
parto	True
supuestamente	False
oídos	False
noción	False
directora	False
productor	False
cuero	True
ciudadanía	True
claves	False
combustible	True
obstáculos	True
esfera	True
cocción	False
caracteres	False
modos	False
sabiduría	False
apreciar	True
constituir	False
contienen	False
negar	False
copia	False
modalidad	False
preocupado	False
sorprendió	False
jardines	True
prefiere	True
fieles	False
ocupan	False
permitan	False
problemática	False
partidarios	False
instrucción	False
acento	True
eléctrico	False
oscuras	False
describe	False
indiferencia	True
volvieron	True
sufren	False
participan	False
emociones	False
llevará	False
griego	True
desastre	False
columnas	True
reuter	False
referirse	False
citar	False
acompaña	False
faltan	True
terrestre	False
determina	False
mínimas	False
quita	False
realizando	False
sudor	True
colectivos	False
creyó	False
mencionar	False
semillas	True
ficción	False
ocultar	False
iniciales	False
resuelto	True
nacionalista	False
comedia	False
contemporánea	False
dedicó	True
integran	False
establecimientos	False
sentó	False
manifestado	False
fachada	True
verdaderos	False
monto	True
inmenso	False
inspiración	False
enfrentarse	False
asesor	True
morales	False
obligó	False
creada	False
intervenciones	False
ternura	False
cansado	False
útiles	False
vuelva	True
rodeado	False
ama	True
aportación	False
exista	False
artificial	False
seguían	True
hueso	True
reír	True
firmar	True
planteado	False
desesperación	False
estímulos	False
accionistas	True
cruzar	False
montón	True
fantasma	True
lección	False
tocado	True
nacionalidad	True
presentará	False
sufrimiento	False
cerro	False
encontré	True
votar	True
broma	False
rol	False
afecto	False
funcional	False
alba	False
fijo	False
orígenes	False
vertical	False
suicidio	True
guardar	False
mandatario	True
defectos	False
psicología	True
escultura	True
perdiendo	True
correspondencia	True
pedía	True
académico	True
ancianos	False
pesca	True
soviético	True
peruano	True
electricidad	True
bebé	True
vasos	True
coro	True
cobrar	False
estadísticas	False
alteración	True
postre	True
medir	True
buscaba	False
desarrollados	False
intentado	False
siguieron	False
alcaldía	False
complicado	True
asilo	False
colocado	False
contento	False
hueco	False
flujo	True
andaba	False
bordo	False
obtención	False
índole	False
justa	False
estudiado	False
peores	False
produciendo	False
sentada	False
solucionar	False
capitalista	True
influencias	False
delincuentes	True
complejos	True
capas	True
comidas	False
conocemos	False
ponga	False
informado	False
celebrará	False
organizada	True
gustan	False
vegetal	False
film	False
caos	False
funcionar	False
desafío	False
claros	False
meter	False
indio	True
tormenta	True
territorial	False
diana	False
traducción	True
alas	True
trate	False
finca	True
propósitos	True
acusó	False
acaban	False
respectivas	False
finalizar	False
rosario	True
fuertemente	False
ofertas	False
instalado	False
violación	False
contribución	True
torero	True
ajena	False
partículas	True
trabajado	True
madurez	True
lateral	False
tomaron	False
solicitó	False
inmigrantes	True
masiva	True
instancias	True
mandó	True
consideraciones	True
horario	False
empiezan	False
incrementar	False
pidiendo	False
confederación	True
echa	False
cultivos	False
inspección	False
ámbitos	True
publica	False
celular	False
gobernar	True
trabajaba	True
cocaína	True
agencias	True
terapia	False
aprobada	False
miran	False
manejar	False
direcciones	False
sexto	False
escaleras	True
usos	False
árabes	False
taxi	True
representaciones	False
importe	True
solicitado	False
acero	True
llegaban	True
impresionante	False
altamente	False
círculos	False
chilenos	False
modernos	False
mediterráneo	True
agenda	False
rebeldes	False
picado	False
experto	True
realizaron	False
realizarse	False
balcón	True
tablas	False
difícilmente	False
lecho	False
reunió	True
monedas	False
clarín	False
precedentes	False
llegará	False
plataforma	False
teórico	False
vegetación	False
coincide	False
jugó	True
nucleares	False
vimos	True
conservadores	True
cabello	True
fortaleza	True
ignorancia	False
contener	False
suceder	False
preso	True
litros	False
maniobra	False
latinoamericanos	True
mera	True
anciano	True
refirió	True
excesivo	False
compras	False
den	False
concluye	True
persecución	True
prado	True
cable	False
saco	True
camiones	False
pantalones	False
denominada	False
tomate	False
captura	False
medalla	True
brillantes	False
inauguración	True
abundancia	False
aspiraciones	False
diplomático	False
implantación	False
supera	False
cumplen	False
ridículo	False
completar	False
optimismo	False
hoteles	False
malestar	True
varones	True
titulares	False
éxitos	False
advertir	True
venganza	True
ampliamente	False
bebidas	True
desnuda	False
deriva	False
licencia	True
emocional	False
sonrió	False
docena	False
admitir	True
centroamérica	False
fina	False
saberlo	False
desprecio	False
contradicciones	True
contradicción	True
convencer	False
énfasis	True
entraba	False
integrada	False
cobre	False
pasará	True
concretamente	False
llegué	True
males	False
defiende	False
bonito	False
copas	False
episodios	False
tiros	False
financiamiento	True
huellas	False
diámetro	False
adicional	False
tradiciones	True
cubre	False
componen	False
viajero	True
distancias	False
crudo	True
exposiciones	True
nostalgia	True
veían	False
parcialmente	False
usuario	True
novio	True
carnes	False
senadores	True
ministra	False
grabado	True
cerrados	True
repitió	True
símbolos	True
indicios	False
plantear	False
escolares	True
pisos	False
chicas	False
alrededores	False
suena	False
expuesto	True
rescate	True
crímenes	True
referéndum	True
volverá	True
sobrevivir	True
competir	False
radicales	False
logro	False
referido	False
confirma	False
informativos	True
lago	False
vídeo	False
obispos	False
casualidad	False
contratación	False
llegamos	False
alivio	False
avanza	False
disponibles	True
citados	False
pregunto	False
alerta	True
asesino	True
reside	True
manteniendo	True
oportuno	True
pensión	True
juicios	True
anuncios	True
participó	False
británicos	False
transferencia	False
residuos	False
prestar	False
titulado	True
sacerdotes	False
ideales	True
trascendencia	False
rechazó	True
mortalidad	True
obrero	False
depósitos	False
mostraba	False
apoyado	False
agregar	False
probabilidad	True
denunció	False
cristiano	True
fidelidad	False
simpatía	False
ausente	False
mero	False
flota	False
algodón	True
herramientas	True
abuso	True
enfrentamientos	True
compuesta	False
rodea	False
litro	True
puertos	True
considerados	False
obvio	False
esperaban	True
eficiencia	True
obstáculo	True
progresiva	True
estreno	True
vacía	False
atentados	True
rumor	True
liderazgo	True
destinada	False
creemos	False
metió	True
trámite	False
divisas	False
lanzamiento	False
lee	False
operativo	False
primo	False
sensaciones	True
apellido	True
observó	True
satélite	True
descubre	False
cruel	False
conjunta	True
modernización	False
ironía	False
bloqueo	True
ambientales	False
ofrecido	False
coordinador	True
aborto	True
acordó	False
sanción	True
muertes	False
daría	True
ideológica	True
tecnológico	False
ganancias	False
consumidor	False
puramente	False
ciego	False
deudas	False
nacionalismo	True
eventual	False
reagan	False
aclaró	True
grueso	False
disparos	True
acompañada	False
amable	False
continúan	False
ligero	False
desarrollan	True
mérito	True
norteamericanas	False
billones	False
brillo	True
perjuicio	False
supe	False
débiles	False
pañuelo	False
centenar	False
excesivamente	False
conducción	False
excelencia	True
produjeron	True
volúmenes	False
surgen	True
registros	True
históricas	False
series	False
prioridad	True
expulsión	False
cerebral	False
últimamente	False
señalando	True
retiro	False
desorden	True
exclamó	False
grasas	False
expresado	False
carencia	False
hígado	True
creando	False
músico	True
ejerce	False
acercamiento	False
bolívares	False
cc	False
previsiones	False
fijar	True
sometidos	False
botón	True
prohibición	True
bronce	True
normalidad	False
reveló	True
carbono	True
infinito	False
admitió	False
preocupaciones	True
ocurría	False
conductas	False
sustituir	True
transparente	True
preside	True
célula	True
bombas	False
magia	False
gestiones	False
suelos	False
aérea	False
declara	False
disputa	False
cúpula	True
significativa	True
destruir	False
utilizada	True
depósito	False
registró	False
consolidación	True
rivales	False
manda	False
sostener	False
inconsciente	False
ruidos	True
respecta	False
ubicado	False
universitario	False
japonés	True
emisiones	True
escuchó	False
poderosa	False
secundaria	False
tratamientos	True
rurales	False
ilegales	True
sencillamente	True
vivimos	True
denominación	False
domingos	False
creencias	True
verbal	False
obligada	True
visitante	True
permaneció	False
muchísimo	False
inmóvil	False
unidos	True
viajeros	True
cumplió	True
químicos	False
mover	False
riego	True
fino	False
chilena	True
preguntaba	False
conferencias	False
geográfica	False
fragmentos	True
trago	False
reúne	False
lanzar	False
núcleos	False
credibilidad	True
seda	True
aportar	False
chinos	True
playas	False
pretexto	False
firmeza	False
publicar	False
poética	False
secreta	False
onda	False
inocencia	False
gases	True
escasez	True
incluida	False
indicado	False
ritual	False
masculino	False
rehenes	False
gustado	False
contraria	True
tubo	True
coincidencia	False
interiores	False
atraviesa	False
educativa	False
afirman	False
das	True
colón	False
muscular	True
vaticano	True
continuamente	False
negativos	False
convento	True
confirmar	True
cerdo	True
sacado	False
esencialmente	False
atribuye	False
llanto	True
placas	True
aventuras	False
variación	False
desconfianza	False
investigador	False
salga	False
amantes	False
locos	False
desayuno	True
préstamos	False
colaborar	False
libremente	False
fijado	True
primas	False
seriamente	False
leyendo	False
violenta	False
antena	True
vitamina	True
aparecido	True
privilegio	True
maestra	True
licenciado	True
eterno	False
pertenecientes	False
iglesias	False
tolerancia	True
presentaba	False
evaluar	True
competición	True
índices	False
ácidos	True
validez	False
electrónico	False
placa	False
rusos	False
magistrados	False
promesas	False
localidades	False
corrida	True
novedades	False
ligera	False
estructural	False
fotógrafo	True
limita	True
convencional	True
bolsas	True
sugiere	False
marcador	True
rentabilidad	True
fruta	False
exigen	False
abordar	False
deportiva	True
digno	True
atracción	True
otorga	False
edades	False
existían	False
prohibido	True
configuración	False
madrileña	False
favorables	False
gama	False
órbita	False
marcada	False
gotas	True
extraños	False
logros	False
creatividad	True
jacques	True
fujimori	True
convierten	False
cosecha	False
considerablemente	False
pagado	True
despedida	True
percibir	False
chocolate	True
ola	False
detectar	True
superado	False
realismo	True
serios	False
volví	False
descansar	True
fumar	True
produzca	False
levantado	False
adhesión	False
compuestos	True
ubicación	True
inseguridad	True
presuntos	True
mm	True
cardenal	True
excelentes	False
salarial	False
controles	False
avanzado	True
ropas	False
desapareció	True
rechaza	False
aproximación	True
inclusive	False
penumbra	True
mortal	False
sumario	False
autobús	True
discusiones	False
trigo	False
aportaciones	True
refieren	True
pesado	True
aumentado	False
experimentado	False
causado	False
transparencia	True
tira	False
cenar	True
casco	True
reposo	True
majestad	False
costó	True
reconstrucción	False
concesiones	True
ondas	True
sagrado	False
corredores	False
testimonios	False
formato	False
separa	False
sucesivas	False
minoría	False
insuficiente	False
práctico	True
pantalón	True
elegidos	False
necesito	True
celda	True
residentes	True
urbanos	True
bloques	False
políticamente	False
pollo	False
fundador	False
recomendaciones	False
imposibilidad	True
retirar	True
marcar	True
cercanos	True
revisar	False
repertorio	False
repetición	False
enferma	False
departamentos	True
disparo	False
aprovechando	True
saliendo	False
contemporáneo	False
gala	False
rector	True
famosos	False
fábricas	True
filósofo	True
diariamente	False
excepciones	False
establecidos	False
gordo	False
concejales	False
llenar	False
afectadas	True
metas	False
modalidades	False
pilotos	False
trozos	True
peligrosa	False
exacta	False
terraza	True
ingresar	False
esperado	False
usado	False
escritorio	True
externos	False
prevenir	False
pico	False
jerusalén	False
cerámica	True
capilla	True
enamorado	False
desarrolló	True
bebida	False
pesadilla	True
suavemente	True
pasadas	False
pluma	True
comenzaba	False
duelo	True
pánico	True
delantero	False
observado	False
acudió	False
retórica	True
invisible	False
amarilla	False
indudable	False
quieras	False
ofrecía	False
salidas	True
minas	False
cirugía	True
describir	True
designación	True
oía	True
disminuye	False
rompió	False
estructurales	False
jerarquía	False
hogares	True
debates	False
representado	False
peces	True
ideológico	False
trampa	True
puse	False
levantarse	False
plazos	False
preparados	False
ciudadana	False
llevo	False
formaciones	True
recomienda	True
permanecen	False
protagonismo	False
desean	True
archivo	False
contando	False
sano	False
decisiva	True
legisladores	True
variedades	True
llevarse	True
aumentó	True
antigüedad	False
colega	True
limitada	False
elevar	True
ilusiones	True
transforma	False
partidario	False
vasca	False
llenos	False
disponible	False
justificación	False
méritos	False
fallecido	True
tomaba	True
específicamente	False
reiteró	False
dureza	False
futuros	True
defecto	False
esquemas	False
suponía	False
rebelión	True
estrecho	False
abría	False
corregir	False
prestaciones	True
transmitir	False
aldea	True
expedición	False
entraron	False
conveniencia	False
gasolina	False
hicimos	True
breves	True
aéreo	False
crecido	False
huella	False
pimienta	False
alcanzan	False
dictador	True
fantasmas	False
perejil	False
presidenta	False
realista	True
contestar	False
transformaciones	True
quedé	False
tecnológica	False
republicano	True
importación	True
avanzada	True
hallazgo	True
serenidad	True
ceder	False
vinculación	True
verme	False
analistas	False
billetes	False
reforzar	False
extradición	True
adopción	True
centenares	False
tarjetas	True
despierta	False
gobernantes	True
rehabilitación	True
modernidad	False
eterna	True
aplausos	True
católicos	True
áfrica	True
empleos	True
géneros	True
invertir	True
discriminación	False
maquinaria	False
estricto	False
firmó	False
introduce	False
pasaban	True
vuelos	False
griegos	False
vecina	False
semestre	False
legalidad	False
bello	False
ambición	True
colombiana	True
científicas	False
marqués	False
fatal	False
comunismo	True
peligros	True
frenar	True
movilización	False
tenis	True
jugado	False
mostraron	False
dirá	False
botellas	False
tome	True
tomada	True
haberlo	True
convenios	True
hablamos	True
reducida	True
parezca	False
gafas	True
lamentable	False
oscuros	False
insectos	True
apuntó	False
escuchaba	True
tienden	False
buscó	False
lleve	False
sargento	False
realidades	False
dirigía	False
reunir	False
instinto	True
escribía	False
universitaria	False
falda	True
querida	False
inscripción	False
manchas	False
envidia	False
restricciones	True
informativo	False
romano	True
demostración	False
volar	False
barrera	True
destacados	False
preferencia	False
poseer	True
demuestran	False
mención	False
creencia	False
gigante	True
justifica	False
dejarse	False
aguda	False
grano	True
abundantes	False
elemental	False
espectro	True
archivos	False
uñas	True
motores	False
ambientes	False
mencionados	False
producía	False
desaparece	True
averiguar	False
opina	False
profundos	False
revolucionaria	False
saltar	True
talleres	False
pulso	False
peticiones	False
sólida	False
adolescencia	True
complicaciones	True
generalizada	False
energías	False
experimental	False
caña	False
balanza	True
gallego	True
manipulación	True
constancia	True
coherente	False
portero	True
espectáculos	False
seriedad	False
magnífico	False
hallan	False
caminando	False
patente	True
condenados	False
tratarse	False
merced	False
digamos	True
mató	True
observadores	False
proponer	False
delicado	False
coger	False
ocupó	False
queja	False
corrió	False
típico	False
incorporar	False
óptica	True
producida	False
presidenciales	False
característico	False
cabellos	True
aporta	False
radica	True
jurisdicción	False
horizontal	True
pacífico	False
asociados	False
salvaje	True
quise	False
financiar	False
proporciones	False
captar	False
afectar	False
suelta	False
exacto	False
violento	False
considerando	True
obsesión	False
vestida	True
síntoma	True
supuso	True
palestinos	True
causó	False
construcciones	False
emitir	False
confrontación	True
servía	False
agujero	True
horrible	False
sucesor	False
relatos	True
rodilla	True
dulces	False
adecuadas	False
reportaje	False
cuidadosamente	False
interpretaciones	False
ajenos	False
menú	False
pescadores	True
divorcio	True
grandeza	False
mata	False
inconveniente	False
emprender	False
autos	False
tirar	False
tapa	False
árbitro	True
trozo	False
llamaban	False
despertó	True
pierden	False
tregua	True
traía	True
afectada	True
compañera	True
amigas	True
popularidad	True
surgido	False
perdieron	False
consultas	False
enseñanzas	False
urnas	True
ruinas	True
marcó	True
acostumbrado	False
sofá	True
barba	False
favorecer	False
tradicionalmente	False
fresca	False
celos	True
auge	True
utilizó	False
biografía	True
matices	True
independientemente	False
rusa	False
desprende	False
democráticos	False
retirado	True
paralelo	False
republicanos	True
andaluz	False
jugada	True
varía	False
restaurantes	False
afirmaciones	True
pájaro	False
luchas	False
comprometido	False
juegan	False
conjuntos	False
inminente	False
quejas	False
princesa	True
encuentre	False
apuesta	True
gobernante	True
rosas	False
establecen	True
contribuye	True
montar	True
pce	True
parado	False
íntimo	False
humilde	False
eficiente	False
trabajó	False
fibras	False
salvación	False
aprovechó	True
irregular	False
abiertamente	False
darme	False
vende	False
complicidad	False
amores	False
radiación	True
escenarios	False
vela	True
emplea	False
móvil	True
reunirse	False
digna	False
innumerables	False
judío	True
insistencia	False
sólido	True
constitucionales	False
pasaje	False
resistir	False
tour	False
calcula	False
crean	False
furia	True
pagan	False
amplios	False
damas	True
aprobar	False
comunitaria	True
bolívar	True
invitó	False
pautas	True
retratos	True
encargo	False
conscientes	False
maravilloso	False
valorar	False
refiero	False
electores	False
cese	True
productiva	False
abrigo	True
sed	False
íbamos	False
porvenir	False
vinos	False
caballeros	True
posturas	True
defensores	True
aplicado	False
experimentos	False
salinas	True
consejeros	True
reflexiones	True
diarias	True
dependen	False
trayecto	False
incorpora	True
rompe	True
poderosos	False
llenas	False
patrones	True
lanzado	False
facilita	False
participado	False
gritar	True
armando	False
descrito	False
ira	False
dejé	True
temores	True
productivo	False
escuchado	False
corteza	True
pacífica	False
parámetros	False
comprendido	False
preferido	False
sucia	False
prudencia	True
aparecieron	False
empresariales	False
adecuados	False
liberalismo	True
equivale	True
impulsar	True
maniobras	True
colocó	True
verduras	False
dramática	False
unanimidad	False
democráticas	False
casarse	False
mantequilla	True
sello	True
mercancías	True
héroes	True
precedente	True
pidieron	False
insistir	False
digas	False
caro	False
injusticia	True
precisar	False
saldo	True
participa	False
monumento	True
creciendo	False
intentaba	False
pistas	False
pechos	True
violentos	False
nube	False
ríe	False
químicas	False
dándole	False
regresa	True
economías	False
exclusivo	True
calcio	True
conocí	False
arzobispo	False
favorece	False
docente	False
venden	False
salían	True
interacción	False
carteles	True
provenientes	True
convocado	False
cargado	False
manifestaron	True
implicados	True
asistieron	True
historiador	True
túnel	False
restauración	True
muchachas	False
deseado	False
laboratorios	True
desconocidos	True
quitar	False
pretensión	False
parientes	False
papas	True
hábito	True
encargada	True
comercialización	True
llorando	True
dejaban	False
rutina	True
integridad	True
correctamente	False
continuaba	False
timbre	True
dedicados	True
dominar	False
mundiales	False
monopolio	True
diré	False
torno	False
secundarios	False
alusión	True
pc	False
competitividad	False
íntima	True
aprovechamiento	False
proviene	True
receptor	True
geográfico	False
señalaron	True
moléculas	True
rechazar	False
hallar	False
quieran	False
variantes	False
cambiando	False
coherencia	True
respirar	False
atacar	False
designado	False
mentalidad	False
impotencia	False
sanitario	True
sostenido	True
ubicada	True
anterioridad	False
escaños	False
plenitud	True
llegara	False
conjuntamente	False
transcurrido	False
capacidades	False
limitó	True
proposición	False
existido	True
sillas	False
asume	True
dependencias	False
consultar	False
llamamos	False
electrónica	True
especialidad	False
rtve	False
creció	False
falleció	False
video	True
esplendor	False
energético	False
proporcionar	False
manzana	False
cuotas	False
joyas	True
caía	True
previstas	True
narración	True
desconocida	True
comenzará	True
telefónicas	False
manual	True
rubia	False
juro	False
enlace	False
comentar	False
darles	True
marxista	False
moderado	False
vinieron	False
pronunció	False
préstamo	True
músculo	False
banderas	True
dotado	False
distingue	True
ptas	False
documental	True
adoptado	True
necesitamos	True
practicar	False
paisajes	False
merecen	False
altar	False
biológica	False
porción	False
exactitud	True
bonos	True
únicas	False
aumentando	False
estilos	True
dejo	False
progresivamente	False
apartamento	True
entendía	False
establecida	False
envío	False
destinadas	False
catedrático	True
sobra	False
iniciaron	False
narrativa	False
amplitud	True
duele	False
sospechas	False
rasgo	True
bola	False
potencias	False
metales	False
abarca	True
nobles	False
previstos	False
procedencia	False
ocupaba	False
ordenado	True
tratara	False
significaba	False
extinción	True
modernas	False
veras	False
colonias	False
adecuadamente	False
inconvenientes	False
fibra	False
recuerdan	False
sonar	False
sentimental	False
secundario	False
mueven	False
pasiones	False
teórica	False
buscado	False
trazado	False
frustración	True
compró	False
abren	False
parecida	False
ingenio	False
operar	False
talla	False
varón	False
times	False
máximos	True
responden	False
expone	False
sabiendo	False
pedirle	True
autónomas	False
atardecer	True
cortos	False
colocación	False
ejecutar	False
duque	True
advertencia	True
refería	False
escasas	False
trasladado	True
engaño	True
reflejos	False
dependiente	True
exploración	True
hondo	True
optimista	False
come	False
interminable	False
dedicación	False
consistía	False
campesino	True
saludo	True
agricultores	False
botas	True
excusa	False
asesinos	False
alcaldes	False
gota	False
corría	True
preparando	False
sonríe	False
lana	False
orillas	True
pozo	False
infantiles	False
buques	False
cuadrado	True
inversores	True
planetas	True
receptores	True
plomo	True
molesta	False
comarca	False
adelantó	True
visitó	False
debida	False
urbanas	False
falsas	False
impidió	True
hablo	False
encargados	False
cuidar	True
lástima	False
soviética	True
impulsos	False
víspera	False
dictamen	False
cometer	False
elegancia	True
legitimidad	False
transformar	False
cinematográfica	True
proximidad	False
lazos	False
sucesivos	True
futuras	False
gráfico	False
quiebra	True
brutal	False
risas	False
experimento	True
soviéticos	False
consiguiente	False
caen	False
suponen	False
relacionada	False
dados	True
rayo	True
ritmos	True
pelos	True
acierto	False
pedazos	False
deficiencias	True
legislatura	False
tortura	True
organiza	False
surgir	False
reivindicaciones	False
administrador	True
trámites	False
saint	False
hacerme	False
moción	False
doméstico	False
superficies	False
culo	False
serias	False
semilla	True
agraria	True
lejana	False
delicada	False
umbral	True
conformidad	False
abrazo	False
mencionada	False
traición	False
relevante	True
establecidas	False
nicaragüense	False
cobra	False
borracho	True
extensa	False
acompañar	True
mortales	False
estudiando	False
presta	False
cucharadita	True
psicológico	False
concede	True
sanitaria	False
exhibición	False
consistente	False
enseñar	True
planteó	False
franquismo	True
garantiza	False
efectividad	True
vivían	True
separados	True
lingüística	True
notablemente	False
reflejan	True
empezando	True
nuca	False
foco	False
pesada	True
quedaría	False
reestructuración	True
confirmado	False
granos	True
percibe	False
parada	True
exponer	False
conversión	True
hierba	True
falsos	False
cercanas	False
whisky	True
niebla	True
prometió	True
conforman	False
obviamente	False
superioridad	False
ordenar	True
supresión	False
terminal	False
idiomas	False
disponen	False
formó	False
inestabilidad	True
revelación	True
reunido	True
cómodo	False
sensibles	False
metáfora	True
dadas	False
prisioneros	False
ciclos	True
señoras	False
hablaban	False
secciones	False
adulto	True
psicológica	False
reclama	False
decoración	True
gustos	False
negado	False
natal	False
integrar	False
identificado	False
naves	False
ganando	False
holandés	True
aroma	False
recuperado	False
prudente	True
sabio	True
musulmanes	True
capacitación	True
denunciar	False
dirigidos	False
fármacos	False
dramático	False
organizadores	False
alcanzaron	False
absorción	False
trajes	False
decadencia	False
espejos	False
manifestantes	True
superficial	True
mineral	False
ediciones	True
solemne	False
vitales	False
intermedio	False
lavado	True
cemento	True
sana	False
cuerdas	True
querella	False
conductores	True
cotidiano	False
escribiendo	False
pronóstico	False
informativa	False
encanto	False
lentitud	False
cárceles	True
enseña	False
intervino	False
cogió	True
decirme	False
leyó	True
mágico	False
sutil	False
debidamente	False
inclusión	True
disponía	True
equivocado	False
oración	False
serbios	True
mantuvieron	True
cayeron	True
laterales	True
verdaderas	True
medellín	True
económicamente	False
intervienen	True
portugués	True
gen	False
catástrofe	True
entierro	True
usando	False
cocinar	False
eficaces	False
monstruo	True
tomarse	False
eleva	True
sostienen	True
fauna	False
causar	False
sorprende	False
convocar	False
aceptable	False
pasillos	False
elevación	True
fatiga	False
pureza	True
indicadores	True
presunta	False
negativas	False
bonita	True
sábanas	True
sigo	False
dirigirse	False
canta	False
importaba	False
lema	False
digital	True
medieval	False
asociado	False
situados	False
vínculos	True
hagas	False
dijera	True
tenor	False
flexibilidad	True
recogida	True
representaba	True
contribuido	False
oculto	True
apetito	True
adicionales	False
memorias	True
preparada	False
acogida	False
chaqueta	True
explican	False
medicamento	True
libras	False
comprado	False
colesterol	True
pa	False
certamen	False
pedazo	False
matado	False
pensamos	False
obrera	False
reunidos	False
anunciar	False
frágil	True
urbanización	True
relativos	False
factura	True
significativos	False
movía	True
eléctricas	False
harto	False
solicitudes	True
amnistía	True
confesión	True
conocían	False
cabecera	False
delirio	False
despliegue	False
ocurra	False
determinante	False
jurídicas	False
cargas	False
dependiendo	False
tocaba	True
vitaminas	True
mostrando	False
divertido	False
anécdota	False
volante	False
pido	True
teme	False
bacterias	False
subido	False
cumpleaños	False
táctica	True
insomnio	False
mete	False
penetración	False
nobleza	False
subasta	False
parciales	True
agrupación	False
abuelos	False
suministro	False
funcionan	True
vendido	True
lógicamente	False
pertenecía	True
verle	True
melancolía	True
lapso	False
cigarrillos	True
pondrá	False
recibirá	False
ferrocarril	False
huida	True
acordado	False
amplias	False
deportivas	True
definida	True
romanos	False
peruana	False
comunitario	False
piedad	False
subsecretario	True
localización	False
masculina	True
revolucionarios	True
mancha	False
automáticamente	False
asesinatos	False
registra	False
señalaba	False
pagó	False
recogido	False
clausura	False
clínico	True
instalar	True
buque	False
escoger	True
teléfonos	True
reconocen	True
almas	False
turístico	True
leña	True
heroína	True
campamento	True
típica	True
superó	False
recaudación	False
obtienen	False
retiró	False
partidas	False
mérida	True
acta	True
encargó	True
vinagre	True
elevadas	False
mármol	True
abusos	False
observador	True
infecciones	True
corrección	True
portada	True
cartón	True
inspector	True
creído	False
potente	False
cubiertos	True
teóricos	True
iluminación	True
medianoche	False
limpiar	True
venció	True
limitación	True
intuición	False
efectuado	False
húmedo	False
provocan	False
favorito	False
cd	False
sexualidad	True
dispuso	True
griega	True
catálogo	False
previsión	False
producciones	False
diputación	False
zedillo	True
líquidos	False
escapa	False
indignación	False
rebelde	False
mensuales	False
educativos	False
echado	True
olvida	False
prefieren	False
gustó	False
octavio	False
vacas	False
concluido	True
cintas	False
confesó	True
correspondía	False
abriendo	False
dejará	False
ala	True
desempeño	False
válido	False
empecé	False
recibía	True
bala	False
decidida	False
criminales	False
secas	False
curiosa	False
mundos	True
hongos	False
privilegios	False
afiliados	False
patronal	False
iría	False
rodean	False
permanentemente	False
piscina	True
domina	False
plumas	True
pintar	False
traduce	False
perfume	True
disolución	True
coraje	True
palos	False
abandona	False
conducido	False
mandos	False
extremadamente	False
expresamente	False
mejillas	True
trono	False
implacable	False
opera	False
arreglo	False
xv	False
pretensiones	False
obedece	False
conceptual	False
rincones	False
corbata	False
aislado	True
tardó	False
fortalecer	True
autonómico	False
exámenes	False
asistió	False
señas	True
muñeca	False
puentes	False
preguntado	False
movilidad	False
vejez	True
olímpicos	True
separar	False
generado	False
desfile	True
sistemática	False
significar	False
viajó	False
continuará	True
informática	False
sucio	False
anualmente	False
cotización	False
leonor	False
volviendo	False
rutas	False
prometido	False
ejecutivos	False
fomentar	True
deberes	True
pongo	False
desenlace	False
autobuses	False
meterse	True
ayudó	True
disciplinas	True
coyuntura	False
aislados	False
consuelo	False
corren	False
grabación	False
viera	False
provocando	False
lámpara	True
carecen	False
estatura	True
penetrar	False
misterioso	False
nacidos	False
examinar	True
predominio	False
atenas	True
editor	False
barato	False
cajón	True
viste	True
delincuencia	False
japoneses	True
radicalmente	False
distante	False
horarios	False
copias	False
producidos	True
alejado	False
fijos	False
turística	True
católico	False
militante	False
relevancia	False
sustancial	False
llevada	False
ajenas	False
nombrar	False
ordenamiento	True
fabricantes	False
aviraneta	False
cumpliendo	True
dirigidas	True
inversionistas	True
porcentajes	True
victorias	True
seminario	False
macho	False
baloncesto	True
consolidar	False
calificación	False
estadística	True
madrileños	True
ayudante	False
preferible	False
verso	False
seleccionar	False
temporadas	False
quitó	False
asumió	True
comprobado	False
seguimos	False
charla	False
ocio	True
olas	True
esculturas	False
poseía	False
trastorno	True
plantel	False
mañanas	True
objetiva	False
estimular	False
francesas	True
retirarse	True
repercusión	True
autonómicas	False
suspender	False
mecánico	True
condujo	False
dedicarse	False
detenerse	False
barroco	True
reflexionar	False
evitando	False
véase	False
procesamiento	True
llaves	True
israelíes	False
mantendrá	True
cortado	False
dormía	True
invita	True
dedican	True
envuelto	False
meramente	False
padece	False
aumentos	False
ingeniería	True
complemento	True
guerrillero	True
asciende	False
bancaria	False
muslos	False
extendió	False
tendido	True
vendedores	True
matemáticas	True
vinculados	False
hembra	True
manifiestan	False
proteína	False
romana	True
formalmente	False
afirmaba	False
penales	False
poblado	False
creativo	False
monseñor	False
adquirió	False
conspiración	True
aplicada	False
vulgar	False
jazz	True
invención	False
maleta	False
subvenciones	True
vinculado	False
pares	False
saldrá	False
concedido	False
suman	False
aficionado	True
diplomática	False
matanza	False
directos	False
defendió	True
perdía	False
ruina	False
insoportable	False
perdidos	False
comportamientos	False
atletas	True
pálido	False
mide	False
falla	False
generosidad	True
complutense	True
quedamos	True
primordial	False
orgulloso	False
ciega	False
requerimientos	True
consideramos	True
apropiado	False
sorpresas	True
veterano	False
maneja	False
rodaje	False
asegurado	True
advertido	True
oí	False
menciona	False
hegemonía	False
setiembre	False
sustituido	False
elementales	False
agudo	False
secos	False
herramienta	False
peruanos	False
emite	False
amar	False
peligrosos	True
concedió	False
artísticas	False
comprendió	False
parques	False
cometidos	False
imposición	True
cuidados	True
naturalidad	True
pata	False
océano	True
controla	False
cerradas	False
autónomo	False
inclinación	False
sentados	False
rechazado	False
grita	False
permitiría	False
fomento	False
relativas	False
culpables	False
acompañó	False
contesta	False
venezolana	True
permanecía	False
faena	False
repetía	True
monarca	True
jugaba	False
gráfica	False
feroz	False
valiente	True
conceder	False
reunieron	False
dispositivo	True
dialéctica	True
especializados	False
pulmones	True
fáciles	True
rastro	True
cobro	False
vencedor	False
portal	True
vacuna	True
devolver	False
utilizadas	False
oliva	True
velas	True
bomberos	True
receta	False
persigue	True
verás	False
dueña	False
ángeles	True
biológico	False
vencido	False
entrando	False
pretender	False
orina	True
terremoto	False
disgusto	False
abismo	True
televisor	False
excesos	True
patatas	False
puño	True
cruce	False
estético	False
monjas	True
lealtad	True
kilo	False
aspirantes	False
preferencias	False
puntas	True
significativas	True
mediación	True
mandar	False
mejoramiento	False
genético	False
demócrata	False
filial	False
lucía	False
mentiras	False
sueldos	False
leía	False
bruscamente	False
africanos	False
clínicas	False
sospechoso	True
comparten	False
analiza	False
fracción	False
paja	True
reclamar	False
consiguieron	False
elevados	False
fundada	False
mueren	True
recordando	False
servirá	True
colmo	False
logran	True
ayuntamientos	False
desconoce	True
regímenes	False
relevantes	False
tonos	False
eventos	False
constituyó	True
formulación	False
procurador	False
curvas	False
bondad	False
sirva	False
molestias	False
indicaron	False
asunción	False
ratos	False
llamo	True
extrañas	True
haití	True
haré	False
agrupaciones	False
sometida	False
barreras	False
contemporáneos	True
asco	False
casada	True
golfo	False
romántico	False
triunfos	False
rencor	False
preservar	True
reaccionar	False
mejoras	False
diseñado	False
anillo	False
interlocutor	False
mágica	True
previos	True
ordena	False
incendios	False
desnudos	False
comunitarios	False
patología	True
sonriente	True
presentados	False
identifica	False
anselmo	False
expresan	False
estratos	False
museos	False
coge	False
abrirse	True
publicados	False
terapéutica	True
introdujo	False
representada	False
sobrino	False
guerrero	False
seleccionado	True
prestado	False
bolsillos	True
cómoda	False
unen	False
divino	False
compensación	True
extendido	False
magnífica	False
japonesa	False
fantasías	False
prendas	False
asesores	False
ladrillos	True
externas	True
enfermera	True
reservados	False
contundente	True
comisaría	False
divina	False
movió	True
electorado	False
reservado	False
entienden	True
trágico	True
viaja	True
frentes	False
girar	True
susto	False
solicita	False
directivo	False
cambian	False
especializado	False
american	False
fabricar	True
mama	True
prolongado	True
sumar	True
ayudado	True
mediano	True
acudieron	True
tarifa	False
presentadas	True
actuó	False
desagradable	False
escuchando	False
hacerla	True
cristóbal	False
dejara	False
prejuicios	True
clic	False
redonda	False
darán	True
abstracción	True
crónicas	False
comparecencia	True
mediana	True
consistencia	True
defenderse	True
previsible	False
tremenda	False
arreglar	False
cubiertas	True
creadores	True
registraron	True
ánimos	True
formales	False
camilo	False
cia	False
belga	True
ente	True
legalmente	True
considero	False
opone	True
acercaba	True
volvería	True
comunicó	False
evidentes	False
calificado	True
vendrá	False
preguntarle	True
monasterio	True
solares	False
degradación	True
bordes	True
transformado	False
enseñó	False
motivación	True
salones	True
vestir	True
desarrollada	True
terceros	False
legislativas	False
cuna	False
destinos	True
indiferente	False
actuando	False
administrativas	True
apoyó	False
deportivos	False
bandeja	False
autora	False
bruto	False
anti	False
vigentes	False
dobles	False
permanentes	True
pobladores	False
trance	True
firmes	False
complejas	True
permitieron	False
decimos	True
porqué	False
latín	True
acompañan	True
injusto	True
sonriendo	False
federales	False
desarrollando	False
tremendo	False
compositores	True
bajando	False
generan	False
carros	False
acude	False
inevitablemente	False
denunciado	True
cielos	False
incorporado	False
expedientes	True
demonios	True
intérprete	False
encerrado	False
contrabando	True
infinita	False
metodología	False
partió	False
interpreta	False
explicado	False
ligado	False
prosa	False
levantamiento	False
probado	True
eternidad	False
iniciada	False
indiscutible	False
sales	False
criticó	False
bancario	False
dejen	True
institucionales	False
naval	True
creí	True
átomos	True
cantando	True
variar	False
aumentan	False
hable	False
discípulos	False
jurídicos	False
impunidad	True
haz	False
articulación	True
autonómica	False
recibiendo	False
influir	True
relevo	False
modesto	False
inmigración	False
mensual	False
facilidades	False
gorda	False
euforia	False
nicaragüenses	False
cantos	False
atravesar	True
comparte	False
trasladar	False
baleares	True
muelle	False
agresividad	False
picada	False
grabados	True
resultante	False
expectativa	False
citas	False
comparar	True
dorado	False
llamarse	False
provinciales	True
haberle	False
académicos	False
escritas	False
vacíos	False
coca	False
azulgrana	False
parados	False
ladrones	False
publicitario	False
atraer	True
amado	True
entenderse	True
conquistar	False
disponibilidad	False
devoción	False
aprecia	False
laberinto	True
puñado	True
che	False
extraer	True
explicaba	True
ramo	True
acorde	False
plástica	True
duerme	True
pasaporte	True
terminan	False
supervisión	True
llamaron	False
centavos	False
jugará	False
regalos	True
resuelve	False
cayendo	False
aspiración	False
inocentes	True
diplomáticos	True
manta	False
pinta	False
interrumpió	False
vínculo	False
contienda	False
medina	False
trenes	True
kilómetro	True
simbólico	False
exclusión	True
tazas	False
refiriéndose	False
narrador	False
mina	True
juzgados	True
demonio	True
recorte	False
vivas	False
dependerá	True
reconocida	True
aristóteles	True
conservan	False
montado	True
llevaría	False
mantenga	False
suaves	True
rotación	True
ordenación	True
clemente	False
enterado	True
instrumental	False
fríos	False
sopa	True
sucesivamente	False
procesión	True
acompañados	False
observando	False
químico	True
camas	True
cortas	False
vestuario	False
citadas	False
adoptada	False
cima	False
pertenecer	False
tiró	False
admirable	False
satélites	True
atento	False
ingenieros	True
calificar	False
chimenea	True
prolongada	False
aliado	True
complicada	False
armamento	False
descarga	True
aspira	False
recipiente	True
telecomunicaciones	True
apoyada	False
confía	False
totales	False
pintado	False
orlando	False
bolso	True
llegaría	False
rito	False
conlleva	False
grises	True
confirmación	False
ida	False
niñez	False
incluidas	False
convención	False
quisieron	False
venezolanos	True
sumo	True
demócratas	False
rentas	False
goma	False
anunciada	False
sarajevo	True
continental	False
exigía	False
calcular	True
extender	False
genial	False
armario	False
plantean	False
abrieron	True
religiones	False
lecturas	False
lograba	False
invento	True
formaban	False
representados	True
caridad	False
mitos	False
investiga	False
digan	False
márgenes	True
dolorosa	False
artificiales	False
combustibles	False
cenizas	True
soñar	False
compás	True
objetividad	True
significados	False
fotógrafos	True
sólidos	False
contará	True
negación	True
historiadores	True
ancha	False
desequilibrio	True
pabellón	False
origina	True
vacías	True
tristes	False
novelista	False
cruzó	True
inversa	False
etarras	True
reelección	True
variados	False
comodidad	False
antepasados	False
alquiler	False
entrañas	False
especializada	False
convirtieron	False
goza	False
prioridades	True
dividido	True
peseta	True
impresiones	True
camiseta	True
andan	False
publicitaria	False
positivas	False
supiera	False
alterar	False
verdades	False
multa	True
caracterizado	True
húmeda	False
templos	False
previas	False
consideradas	True
paralela	False
profundizar	True
marino	False
siniestro	False
violaciones	False
repetidas	False
añadido	False
podíamos	True
galerías	False
ritos	False
legislativo	True
uruguayo	True
psicosis	False
puestas	False
enterarse	False
apoyan	False
gatos	True
roque	False
razonamiento	True
pasaría	True
cruza	False
inquietudes	False
agregado	True
manzanas	False
aleja	False
temática	False
gozar	False
hilos	False
marxismo	True
inesperado	True
prefiero	True
disparar	False
descarta	False
ceremonias	True
bares	True
presidido	False
incorporarse	True
prestación	False
latinoamericana	False
actuado	False
llamamiento	False
recomendable	False
siembra	True
mares	False
realice	True
cuantía	False
estatutos	True
diferencial	False
venas	True
confundir	True
remate	False
lata	True
requisito	True
aguantar	False
cualidad	True
vistas	True
votantes	False
formular	False
organizó	False
arquitectos	True
replicó	False
presidida	False
imagino	False
dejarlo	False
termine	False
salí	False
mercancía	False
autopista	True
pesados	False
molde	True
apuntan	False
transmite	True
sonora	False
derrotado	False
trasladó	False
verte	False
conversar	True
jubilación	False
arias	True
queden	False
cantantes	True
construida	False
académica	True
pekín	True
desconcierto	False
prólogo	True
veamos	True
guardaba	False
procesado	False
damos	True
constituida	True
cráneo	True
defensiva	False
ratón	True
gravemente	False
espontánea	False
mejoría	False
cristianismo	True
energética	False
huelgas	False
inútiles	False
impiden	True
existan	True
perderse	False
tinta	True
unir	False
primitivo	False
relleno	False
disparó	False
párpados	True
apartados	False
comunicar	False
franja	False
gratuita	False
inesperada	False
nomás	False
desaparecidos	True
literalmente	False
auditorio	True
divide	True
sinceridad	True
ajedrez	True
terribles	False
gobernadores	False
embarazada	True
contenida	False
interviene	True
operan	False
físicamente	False
almirante	True
burla	True
registrados	False
consumir	True
caracterizan	False
tocando	True
imaginario	False
miserable	False
competente	False
generalizado	False
discreción	False
diferenciación	False
pianista	True
contribuyen	False
manifestar	False
respondía	True
terminaba	True
consigna	False
semejanza	False
adversario	True
contribuyó	False
cumpla	False
estricta	False
sábados	False
agonía	True
deportistas	True
proponen	False
matrícula	True
diplomáticas	False
recibida	False
subiendo	False
decidí	False
resoluciones	False
parroquia	False
ejércitos	False
coincidieron	False
latinoamericano	True
convencidos	False
pronunciado	False
extracción	False
proyecta	False
ocupada	True
severa	False
anotó	False
cascos	True
progresivo	False
curación	True
masivo	False
conducen	False
atractiva	True
manto	False
izquierdas	True
misiones	False
defensas	False
sujeta	False
prefirió	False
fijación	False
billete	False
especulación	False
feo	True
innovación	True
provecho	False
burocracia	False
gruesa	True
esferas	False
preferentemente	False
expulsado	False
retira	False
patrocinio	True
salvó	False
suscrito	False
delgado	False
irme	False
extenso	False
sustancialmente	False
bancarias	True
conservadora	True
encontrará	False
pasé	True
comprendo	False
compartido	False
valía	False
fundamentos	False
vuelvo	True
efectúa	False
ético	False
cercanías	False
expuso	True
pesa	False
segmento	False
seguirán	True
jamón	True
centra	False
helicóptero	True
operadores	False
marinos	True
lleguen	True
retroceso	False
espaciales	False
adelantado	False
matriz	False
caudal	True
llevamos	False
crecen	False
nocturno	True
múltiple	False
nuboso	False
yendo	False
determinan	False
gallina	True
mejorado	True
virtual	True
fundado	False
misiles	False
medallas	False
controlada	True
abstracto	False
primario	False
juveniles	True
sacrificios	True
suspendido	False
ordenadores	False
maravilla	False
códigos	True
intentaron	True
gritando	False
superación	False
esclavitud	True
construye	False
paulatinamente	False
besos	False
preguntarse	False
generoso	False
tramos	True
salvado	False
miraban	False
biblia	True
acabo	False
hicieran	False
riguroso	False
escudo	True
lecciones	True
insuficiencia	True
serrano	False
curar	False
recorre	False
reparación	True
intensamente	False
escondido	False
nieto	False
introducido	False
significó	False
bestia	False
concretar	False
expuestos	False
atiende	False
disimular	False
voluntariamente	False
paquetes	False
queriendo	True
multinacional	False
sodio	True
preocupante	False
situar	True
recomendación	True
administrativos	False
freno	True
consume	False
homicidio	True
pactos	False
ocurriendo	True
observan	True
hervir	False
potenciales	True
ingresó	False
heredero	True
francos	False
ponían	False
estudió	True
indemnización	True
séptimo	False
profesorado	False
indicaciones	True
sencillez	False
paradoja	True
ocurren	False
inventado	False
canela	True
excitación	True
compensar	False
frescos	True
homosexuales	False
estrés	False
adversarios	False
calorías	False
confiar	False
variadas	False
temía	False
protegido	True
afueras	False
diligencias	True
descender	False
romántica	True
envía	False
plana	True
hispano	False
lejanos	True
quehacer	False
álbum	True
celeste	False
borrar	True
temprana	True
aseguraba	True
relaciona	False
ganancia	True
involucrados	False
pasamos	True
válida	False
arranque	True
senos	False
bailes	True
cómplice	True
filósofos	True
impuesta	True
deseable	False
legítimo	False
almacén	False
inquietante	False
controlado	False
feto	True
saltó	True
acompañaba	True
situarse	True
industrialización	True
decida	False
llenó	True
maravillosa	True
enmienda	False
voluntarios	True
captación	True
atenta	False
aportes	True
esperamos	True
efectuó	False
ordinario	False
acera	True
visibles	False
melodía	False
narcotraficantes	False
navegación	True
variante	False
concepciones	False
reúnen	True
rubio	False
robado	True
productivas	False
iniciación	False
idéntico	False
optar	False
pez	False
brigada	False
potable	True
sonreír	False
camina	False
califica	False
inauguró	True
adquieren	False
precauciones	True
resolvió	True
pegado	False
gestación	False
verán	True
variado	True
moderada	False
toreo	True
visiones	True
empleada	False
rodeada	False
incapaces	False
presuntamente	False
fianza	True
centenario	False
ilustre	False
fundó	False
monumental	False
dotación	False
partiendo	True
consecución	False
doctora	False
reparar	True
bebe	False
traen	False
ecuación	True
acabaron	False
colaborador	True
mitin	True
usados	False
cortinas	True
mineros	True
esconde	False
pedí	False
detectado	False
maldito	False
aseguraron	False
asociada	False
producidas	True
dedicadas	False
tomo	False
terminaron	True
rescatar	False
tomates	False
desesperado	False
espíritus	False
conexiones	True
proporcional	False
decirte	False
absurda	False
procuraduría	False
dudar	False
agotado	False
otorgar	True
monetario	False
desigual	False
cuaderno	True
telón	True
procesados	False
pasear	True
temporales	False
definen	False
sospechar	True
mono	True
luchando	False
temo	False
redujo	False
estratégico	True
dirigen	True
cirujano	True
yemas	False
vitalidad	False
vicio	False
estratégica	False
doloroso	False
sucedía	False
primitiva	False
valioso	False
utopía	True
poético	False
ofreciendo	False
puros	False
calientes	True
descubrimientos	False
uniformes	False
mutuamente	True
elegida	False
desempeñar	False
dijiste	False
precisas	False
reconstruir	True
tacto	True
incorporó	True
enormemente	False
creyendo	True
cortó	False
estrechamente	False
reconciliación	True
dispersión	True
veneno	True
vertiente	True
recogen	True
colocan	True
faltas	True
electrones	True
insólito	False
producirá	False
vengo	True
láminas	True
proceden	False
temblor	False
protocolo	False
cinturón	False
alianzas	True
confiesa	False
adaptarse	True
higiene	True
someterse	False
helms	False
palinuro	False
triángulo	True
réplica	False
criado	False
aluminio	True
perteneciente	False
invertido	False
sanitarios	False
filosófica	False
confuso	False
bata	False
américas	False
revelan	True
enteramente	False
unánime	True
levemente	False
legado	True
acuden	False
sitúan	False
compasión	True
temer	False
cruzado	True
permanecido	True
misteriosa	False
muertas	False
aviación	False
trapo	True
composiciones	False
hierbas	False
cortesía	False
rallado	False
nacen	True
coma	False
convencimiento	False
recesión	False
medicinas	True
compatriotas	False
voluntaria	True
cuadra	False
alcoholismo	True
violín	True
camarero	True
surgieron	True
futbolista	False
ejes	False
quedo	False
almacenes	True
dedicar	False
textura	False
reclamo	False
silueta	False
ayudan	False
aceptada	False
anciana	False
ecológico	False
literarios	False
nacho	False
sigan	True
explotar	False
futbolistas	True
batallas	False
especialización	False
asumido	False
convirtiendo	False
racionalidad	False
metálico	False
bastón	False
tecnológicos	False
frontal	False
vendedor	True
ratas	False
depresivo	False
depresiones	False
educativas	False
renacimiento	True
soberbia	True
despertado	True
entrenamientos	True
retención	True
crueldad	False
sufrieron	False
subraya	True
tomadas	True
salimos	True
valles	False
diálogos	False
recto	False
convergencia	True
divisa	False
auxilio	False
optó	False
gritaba	True
saliva	True
proliferación	False
prever	True
vean	False
facciones	False
divisiones	False
olla	True
nómina	False
seguidos	False
hormonas	True
convocó	True
hornos	True
idiota	False
levantaba	True
liquidación	True
pasajes	True
rápidos	False
lienzo	False
secuestrado	False
alcanzaba	False
apreciación	False
manga	True
comentado	False
largamente	False
enmiendas	True
semanario	False
creían	True
interesaba	False
revelado	False
desacuerdo	False
flexible	False
atrevió	False
libra	True
balas	False
dejamos	False
correlación	True
marchó	False
serpiente	True
ligada	False
limitar	True
mencionadas	False
interesan	False
fotográfica	True
ministerial	False
prosperidad	True
excepcionales	True
escape	True
enviados	True
discreto	False
discípulo	True
pascual	False
cereales	False
silenciosa	False
sonoro	False
crucial	False
fijó	False
repercusiones	False
sendero	False
aparecían	False
nudo	False
mejilla	True
canadiense	True
estallar	False
erosión	True
obtuvieron	False
emisor	True
aceptan	True
cineasta	False
anunciaba	False
encabeza	True
cauce	False
lavar	False
obligatorio	True
eligió	True
flamenco	False
rebaja	False
descontento	False
ricas	True
tope	False
polo	False
considere	True
economista	True
ocupados	True
preocuparse	False
coincidir	True
niegan	False
circuitos	False
restante	True
demora	False
indirectamente	False
despejado	True
simpático	False
recetas	False
oyentes	False
licencias	False
dorada	False
cueva	False
molesto	True
africano	True
encierra	True
concentraciones	False
cinematográfico	False
pronunciar	False
curiosos	False
quieto	False
velada	False
inspectores	True
unirse	False
hidrógeno	True
amargo	True
terrestres	True
encender	True
apoyos	False
dinámico	False
administrar	False
convocada	True
geometría	True
secuencias	False
montes	True
soltó	False
regulares	False
progresista	True
corrido	True
narices	False
mostrador	True
minorías	True
recuento	True
tropical	False
acuerdas	False
padecen	True
agresiones	True
prostitución	True
cuñado	True
aurora	True
recogió	False
gradual	True
administraciones	False
aclara	False
cogido	False
tumores	True
liberalización	True
fragmento	False
estalló	False
titulada	False
jacinto	False
protestar	False
critica	False
brisa	True
amarillas	False
focos	False
custodia	False
mutuo	False
razas	True
cohesión	True
quedarán	True
candidaturas	True
obtenida	False
durar	False
mate	False
extremidades	True
preocupes	True
faltó	False
cargar	False
fósiles	True
regula	False
cerco	False
decepción	True
insultos	False
cesar	False
prosiguió	False
convencionales	True
sandinistas	True
espectaculares	False
tibia	True
legislativa	True
auténticos	False
liberar	False
mayoritario	False
nocturna	True
combinaciones	True
encendido	False
rendir	False
enteros	False
maldita	True
nativos	False
precioso	False
telas	True
eléctricos	False
desarrollarse	False
contratar	False
brasileña	False
alejarse	True
indicación	False
guardan	False
sonó	False
viabilidad	False
sugerencias	True
construyó	False
discrepancias	False
socialmente	False
palmas	False
lineal	True
explosivos	False
combates	False
vísperas	False
provienen	True
aplican	False
sexta	True
agradecimiento	True
evidencias	False
móviles	False
ventanilla	False
repetido	True
subrayar	False
cabía	False
movido	False
legislador	True
orientales	True
formidable	False
descendientes	False
musculares	False
hermosas	True
dionisio	True
helado	True
renovar	False
vayas	False
comercios	False
tomas	False
escogido	False
vocales	False
espuma	True
aplicarse	False
vendría	False
bando	False
monumentos	False
precisos	False
seleccionados	True
aguja	True
batería	True
contribuyentes	False
hallazgos	False
abastecimiento	False
gigantesco	False
dispuestas	False
visuales	False
codo	True
afortunadamente	False
terminada	False
formados	True
precipitaciones	False
torpe	False
avanzando	False
enteras	False
talante	False
recibo	False
inserción	False
rodar	False
marcharse	False
mutua	True
interpretado	False
funda	False
toreros	True
llamando	False
autorizado	False
incómodo	False
lucrecia	False
derivadas	False
mudo	False
diosa	False
fugaz	False
suavidad	True
fracasado	True
activamente	False
rige	False
vitoria	False
arcos	False
suizo	True
despido	True
prescindir	False
botones	False
sugirió	False
ofrecieron	True
ignorar	True
dominación	True
designar	False
mozo	False
implicaciones	True
enfrentan	False
francamente	False
determinó	False
amorosa	False
rentable	False
resaltar	False
organizados	False
preparan	True
inmediatos	True
anunciaron	False
calibre	False
sumó	False
originalidad	False
lucidez	False
cocido	True
vestíbulo	False
ezequiel	False
históricamente	False
estables	False
finas	False
guapa	False
pipa	True
republicana	False
bajado	False
protector	True
cejas	False
sentencias	True
rebeldía	True
desesperada	True
parecidos	False
ignora	False
cortina	True
cubren	False
comprobó	False
opositores	True
interrogantes	True
colecciones	False
resta	True
reproducir	True
suceden	True
tirado	False
agitación	False
amargura	False
devolución	False
sostenía	False
iniciará	False
subía	False
envergadura	False
mandado	False
vértigo	False
ángulos	True
idéntica	False
instaló	True
recuperó	False
corridas	True
alzó	False
murmuró	False
arranca	False
estallido	False
lío	False
certificado	False
disminuido	False
extra	False
celebran	False
vinculadas	True
severo	False
exigió	True
enfermería	True
asoma	True
comerciante	False
castellana	True
creativa	False
prolongación	False
encuentren	False
especializadas	False
domésticos	False
definió	False
membrana	True
liberado	False
excursión	True
concentrado	True
trataron	True
doctores	True
faltaban	False
conducía	False
ascensor	True
aconsejable	False
cal	False
ponerle	False
capricho	False
quedara	False
asientos	False
cátedra	False
dispositivos	False
vería	False
acostumbrados	False
dinamismo	False
contemplación	True
sereno	False
interesada	True
acumulado	False
dominantes	False
falsedad	False
movilizaciones	True
verificar	False
honestidad	False
prenda	False
conformación	False
usaba	False
cautela	False
voluntario	True
simbólica	False
dormida	False
encarga	False
compone	False
chorro	False
descomposición	False
lomo	False
viceversa	False
pecados	False
concha	True
andaluza	False
callado	False
camioneta	False
agresivo	True
trágica	True
contrarios	True
inventar	False
mapas	False
iniciarse	True
prisionero	False
pasara	False
auxiliar	False
abanico	False
generosa	False
atractivos	True
ave	False
vocero	True
biología	True
electo	False
salvajes	True
formaron	False
escándalos	False
nutrición	True
carcajada	True
directas	False
polémico	False
molécula	True
milagros	True
despidió	True
opresión	True
imaginaba	True
revelar	True
comporta	False
defendido	False
cantabria	False
artísticos	False
filosófico	False
instalada	False
superan	False
curas	False
sincero	False
inmediaciones	False
difunto	False
velo	True
encierro	False
millas	True
linda	False
separan	False
volverse	False
reinado	True
incumplimiento	False
oficios	False
leves	False
ideológicas	False
mixta	False
nutrientes	True
eguren	False
transferencias	True
recupera	False
realizador	False
paradigma	False
contenía	True
ganan	False
saludable	False
puntualizó	False
consorcio	False
aislada	False
diversión	True
refuerzo	False
fortalecimiento	False
saltos	True
jaula	True
contratado	False
mezclar	True
silencioso	False
rendimientos	False
párrafos	False
deficiencia	True
tele	False
helicópteros	True
saludar	False
sagrada	True
incipiente	True
reivindicación	False
arrastra	False
dominado	False
cañón	False
favoritos	False
franquista	False
convertida	False
pastor	True
patricio	False
productivos	False
fallas	True
inicios	False
contraloría	True
difundir	True
sequía	True
etiqueta	False
adelantar	False
resiste	False
show	False
metabolismo	True
extraordinariamente	False
mataron	False
afectó	True
campanas	True
ambigüedad	True
adoptó	False
registrar	False
soberano	True
comiendo	False
concebir	False
opuesta	False
bulto	True
ideologías	False
kid	False
convierta	False
situó	False
súbita	False
irreversible	False
influye	False
promotores	False
emitió	False
brinda	False
fray	False
atributos	True
vendió	True
misterios	True
arterial	False
aprendió	False
sandinista	True
diversa	False
petrolera	False
sufriendo	False
tribu	False
cónsul	False
contracción	False
rigidez	True
equivalentes	True
alfombra	False
sartén	True
itinerario	True
obligan	False
adjunto	False
protege	False
redondo	False
amistades	False
licitación	True
arrancó	True
banqueros	False
sirvieron	True
desigualdad	False
reconocidos	True
tomará	False
aliviar	False
editoriales	False
indudablemente	False
adjudicación	False
novios	True
atendiendo	False
guantes	True
funcionales	False
larra	False
compadre	False
casó	True
asistente	True
asistido	False
