word	group_known
año	True
país	False
ver	False
caso	True
vida	False
hombre	True
forma	True
pasar	False
decir	False
presidente	True
hacer	False
mujer	True
mundo	False
querer	False
llegar	False
español	True
dejar	True
nacional	True
partido	False
persona	False
grupo	False
público	False
quedar	False
ir	False
mano	True
punto	True
millón	False
problema	True
dar	False
social	True
política	False
político	False
obra	False
salir	False
ciudad	True
encontrar	True
volver	True
seguir	False
pensar	True
sistema	True
importante	False
tipo	False
mes	False
económico	False
agua	True
cambio	True
derecho	False
alto	False
situación	True
frente	True
hablar	False
noche	True
poner	False
tomar	False
empresa	True
historia	True
padre	True
venir	False
fuerza	False
proceso	True
centro	False
relación	True
único	False
vivir	False
parecer	False
esperar	True
servicio	False
producir	True
palabra	True
pueblo	True
hijo	True
mantener	True
pequeño	False
cuerpo	False
permitir	True
siglo	False
nombre	True
mirar	False
sociedad	False
llevar	False
presentar	False
llamar	False
acción	True
ojo	True
creer	False
puesto	True
humano	False
niño	False
número	True
él	True
gente	False
ministro	True
semana	True
realidad	True
nivel	False
tierra	True
libro	True
programa	True
equipo	False
joven	True
resultado	True
desarrollo	False
proyecto	False
guerra	True
recordar	False
saber	False
actividad	True
razón	True
necesario	True
familia	False
estudio	False
zona	True
idea	True
tema	True
muerte	True
entrar	True
madre	False
internacional	False
condición	False
paso	False
interés	False
comenzar	True
principio	False
cabeza	False
calle	True
mañana	False
señor	True
información	False
sector	False
voz	False
don	False
buscar	False
sentir	False
puerta	True
medida	True
militar	False
efecto	True
director	False
movimiento	True
preguntar	False
posibilidad	False
mercado	True
empezar	True
viejo	False
fondo	False
orden	True
pedir	True
luz	True
resultar	False
aparecer	False
tratar	False
policía	True
peseta	True
hora	True
real	False
principal	False
imagen	False
miembro	True
llamado	False
blanco	True
recibir	False
actual	False
papel	True
amigo	True
especial	False
falta	True
comisión	False
campo	True
necesidad	False
cosa	False
camino	False
organización	False
seguridad	False
minuto	True
negro	False
comunidad	True
figura	False
acabar	False
europeo	True
capital	True
banco	True
decisión	True
producto	True
mayoría	False
perder	False
espacio	True
interior	False
servir	False
futuro	True
fuente	False
función	True
personal	False
oficial	False
investigación	True
popular	False
juego	True
objetivo	False
duda	False
libertad	False
base	False
clase	False
abrir	False
contar	True
arte	True
medio	False
lograr	False
conocer	True
difícil	False
pie	True
ocasión	False
ocurrir	False
objeto	True
elección	True
central	False
ofrecer	True
menor	False
jefe	True
causa	True
población	True
cultura	True
presente	True
música	True
dio	False
producción	True
médico	True
recurso	False
autor	True
dinero	True
línea	True
dirección	False
aspecto	False
precio	True
fuerte	False
muerto	True
color	True
convertir	False
santo	True
vista	False
presencia	True
distinto	False
considerar	True
asunto	False
autoridad	False
resto	False
civil	False
elemento	True
cara	False
consecuencia	False
acto	False
visto	False
carácter	False
gustar	False
dólar	True
diario	True
posición	True
peso	True
dato	False
argentino	False
julio	False
francés	True
gracia	False
hecho	False
natural	False
economía	True
común	False
caer	False
conocido	True
edad	False
cambiar	False
época	False
superior	True
conjunto	True
libre	False
experiencia	True
rey	True
especie	False
región	False
seguro	False
alcanzar	True
mostrar	True
llegado	True
comunicación	True
carta	True
capacidad	False
cumplir	False
serie	False
reunión	False
técnica	False
antiguo	False
mundial	True
contrario	True
término	False
entender	True
obtener	False
control	True
cargo	True
socialista	False
enfermedad	True
cantidad	False
opinión	True
referir	False
defensa	True
profesional	True
suponer	False
prueba	True
respuesta	False
utilizar	False
ganar	False
aire	False
terminar	True
jugar	True
artículo	True
prensa	False
cuarto	True
justicia	True
poder	False
privado	True
local	False
abierto	False
físico	True
crisis	True
malo	False
cuadro	True
evitar	True
realizar	False
mesa	True
operación	False
compañía	False
ministerio	False
unidad	True
televisión	True
izquierda	False
escribir	False
norteamericano	True
exterior	True
cuestión	False
área	True
administración	False
continuar	False
juez	True
material	False
largo	False
paciente	False
institución	False
salud	True
escuela	False
cultural	False
paz	True
trabajador	False
película	True
decidir	False
establecer	False
morir	False
estructura	True
metro	True
necesitar	False
educación	True
energía	False
ayuda	False
actitud	False
esfuerzo	False
nación	True
silencio	True
muestra	False
texto	True
conocimiento	True
histórico	False
responder	False
constituir	True
atención	True
allá	False
importancia	True
apoyo	False
científico	True
explicar	True
encuentro	True
formar	False
modelo	True
origen	False
hermano	True
declaración	False
suelo	True
extranjero	True
calidad	True
capaz	False
lucha	False
práctica	False
título	True
secretario	False
determinado	False
ciencia	False
brazo	True
máximo	True
bajo	False
escrito	False
solución	False
cine	True
animal	True
campaña	False
iniciar	False
propuesta	False
cabo	False
sueño	True
río	False
fecha	False
contenido	False
naturaleza	False
grave	False
ejército	False
sol	True
mar	False
especialmente	True
reforma	False
informe	True
materia	True
motivo	True
personaje	False
régimen	True
duro	False
electoral	True
interno	False
entrada	True
marco	False
éxito	False
señal	False
correr	True
incluir	False
carrera	True
expresión	True
concepto	True
organismo	True
vuelta	True
pobre	False
radio	True
sangre	True
domingo	True
particular	False
vía	False
ambiente	True
dirigente	False
familiar	False
corte	False
parte	True
soler	False
reconocer	True
formación	False
fiscal	False
diputado	False
característica	True
crear	True
cámara	False
responsable	False
democrático	False
representar	False
dolor	True
factor	True
tribunal	True
boca	True
mínimo	False
doctor	False
tercero	False
afirmar	False
américa	True
período	False
documento	False
planta	True
grado	False
arma	True
precisamente	False
técnico	True
señalar	False
existencia	True
ciudadano	True
jugador	True
líder	False
industria	False
suficiente	False
tratamiento	False
teatro	True
directo	False
mirada	False
aumentar	False
asociación	True
lleno	True
dispuesto	False
construcción	True
etapa	True
crecimiento	True
dirigir	False
actuar	False
puerto	True
deseo	False
sala	False
noticia	False
perdido	False
riesgo	True
plazo	False
derecha	False
asegurar	False
representante	False
momento	True
amplio	True
sacar	False
industrial	False
propiedad	True
funcionario	True
vino	True
claro	False
fácil	True
rojo	False
levantar	True
hija	False
escuchar	True
profundo	True
observar	True
inversión	True
leer	False
desarrollar	False
señora	True
norte	True
candidato	False
salida	False
sufrir	False
frío	False
tiempo	True
pleno	False
ejecutivo	False
participación	True
visita	True
página	True
juicio	False
finalmente	True
marcha	False
comercial	False
fundamental	True
municipal	False
armado	False
alemán	True
mitad	False
voto	True
sur	False
significar	False
grande	True
periodista	True
participar	True
responsabilidad	True
curso	True
aumento	True
dicho	False
crítica	True
miedo	True
terreno	False
oportunidad	False
contacto	False
existir	False
tarea	True
simple	True
comercio	True
pagar	True
valor	False
mayo	True
maestro	True
financiero	False
acerca	False
anunciar	False
memoria	False
conflicto	True
análisis	False
venta	False
presión	True
democracia	True
vecino	False
periódico	False
corazón	True
compañero	True
pretender	False
mayor	True
inmediato	False
golpe	False
mexicano	False
diferenciar	False
cama	True
profesor	False
carne	True
ocupar	False
completo	False
isla	False
negocio	False
estudiar	False
oposición	False
pese	False
declarar	False
aceptar	False
secreto	True
teoría	False
suceder	False
sujeto	False
favor	False
extremo	False
hospital	True
enero	True
artista	True
destacar	False
conciencia	True
atrás	True
rostro	False
dificultad	False
fenómeno	False
circunstancia	True
demanda	False
victoria	True
pensamiento	True
novela	True
estilo	False
lengua	False
diciembre	True
fuego	False
ingreso	True
preciso	False
provocar	True
mejor	True
creación	False
altura	True
adecuado	False
ejercicio	True
lista	False
concreto	False
previsto	False
negociación	True
error	False
indicar	False
suerte	False
club	True
método	True
enorme	False
corto	False
capítulo	False
demostrar	False
guardia	True
revolución	False
norma	False
cielo	True
voluntad	False
corresponder	False
sitio	False
edificio	False
departamento	False
traer	False
seguido	False
coche	True
herido	True
cifra	False
criterio	False
plano	True
entidad	False
normal	False
gesto	False
distancia	True
asimismo	False
aplicación	False
tocar	True
serio	True
permanecer	False
primero	True
junio	True
agente	False
tratado	False
pena	False
próximo	True
octubre	False
fiesta	True
judicial	True
inglés	True
fútbol	True
conversación	True
flor	True
actuación	True
beneficio	False
escena	False
década	True
mensaje	False
intención	False
destino	False
red	False
pieza	False
hotel	True
extraño	True
piedra	False
exposición	False
mover	True
peligro	True
comprender	True
similar	False
discurso	True
absoluto	False
religioso	False
violencia	True
presupuesto	False
víctima	True
provincia	True
moral	True
tradicional	False
corriente	True
andar	False
exigir	False
intervención	True
pérdida	True
general	False
territorio	False
nota	False
individuo	False
jamás	False
gasto	False
impuesto	False
alimento	True
doble	False
gusto	True
pintura	False
reciente	False
límite	True
definitivo	False
vehículo	True
poseer	False
oscuro	True
competencia	True
resolver	False
consumo	True
alma	True
instrumento	False
siguiente	False
positivo	False
básico	False
rápido	False
procedimiento	True
escritor	True
reunir	True
estudiante	False
vivo	False
par	True
detalle	False
propósito	False
instituto	True
revista	False
empresario	True
disponer	False
subir	False
masa	False
dirigido	False
correspondiente	False
abogado	True
verde	True
lenguaje	False
numeroso	False
oficina	True
tendencia	True
gestión	True
oro	False
presentado	True
hoja	True
versión	False
abril	True
moderno	False
complejo	False
pared	True
producido	True
referencia	True
influencia	True
sostener	False
actor	True
imposible	True
realizado	False
labor	False
marzo	False
disposición	False
reacción	False
jornada	True
sentimiento	False
cubano	True
septiembre	True
anterior	True
intentar	True
kilómetro	True
italiano	True
puro	False
ataque	False
superficie	True
alcalde	True
piel	True
visión	True
sombra	True
temporada	False
cerrado	False
celebrar	False
pierna	True
representación	True
trabajo	False
conducta	False
niña	False
teléfono	True
vacío	False
trabajar	False
depender	False
frase	False
tradición	False
oír	False
ventana	True
chino	True
caballo	True
sensación	True
compromiso	False
comité	False
transporte	True
noviembre	True
conducir	False
proponer	False
palacio	True
crédito	True
enfermo	True
contrato	True
advertir	False
habitación	False
temperatura	True
viento	False
doña	False
manifestación	True
rico	False
esperanza	True
cadena	True
justo	True
utilizado	False
regional	False
fase	True
negativo	False
específico	False
canal	True
colegio	True
instante	False
matar	False
ritmo	True
comunista	True
tono	True
surgir	False
colectivo	True
barrio	True
soldado	False
ámbito	True
pago	True
nacer	False
debate	False
citado	False
ley	True
delito	True
jurídico	False
diálogo	False
comienzo	True
intelectual	False
dedo	False
ayuntamiento	True
negar	False
sindicato	False
selección	True
urbano	False
relacionado	True
espíritu	True
legal	False
lunes	True
empleado	True
verano	True
árbol	True
mecanismo	True
agosto	False
azul	True
alumno	False
cerrar	False
entrevista	True
poeta	True
lugar	True
droga	False
contener	False
triunfo	False
vender	False
impedir	False
raíz	False
realmente	False
afectado	False
afectar	True
sábado	True
activo	False
considerado	False
ventaja	False
instalación	True
catalán	True
estrategia	False
directamente	False
vestido	True
apoyar	False
viernes	True
comida	False
confianza	True
personalidad	False
iniciativa	False
marido	False
caber	False
caja	True
frecuencia	True
espalda	True
totalmente	False
establecido	False
descubrir	True
clásico	True
piso	False
final	False
marca	True
evidente	False
escenario	False
unir	True
esposa	False
entero	False
generación	False
volumen	True
acceso	False
previo	False
detener	False
dormir	True
protección	True
comer	False
echar	False
deber	True
detenido	False
vivienda	False
franco	False
dedicado	False
pertenecer	False
presidencia	False
febrero	True
firma	True
lógico	False
junto	False
pareja	True
carretera	False
museo	True
federal	True
evolución	True
vasco	True
superar	False
pan	False
pelo	True
crecer	False
deuda	False
toro	True
sentar	False
defender	False
tasa	True
reducir	False
constante	True
independiente	True
destinado	False
determinar	True
externo	False
avión	False
hermana	True
café	True
elevado	False
oferta	False
abajo	False
cercano	False
bajar	False
diferencia	False
tecnología	True
original	False
calor	False
mamá	False
perspectiva	False
casa	False
querido	False
sesión	False
clave	False
definir	True
sonido	True
abandonar	False
obligado	True
sexual	False
feliz	False
aplicar	False
aparato	False
consistir	False
ropa	False
posterior	False
oído	True
eléctrico	True
estrella	True
titular	True
habitual	True
rato	False
respeto	False
hallar	False
cárcel	True
famoso	True
parlamentario	False
literatura	False
comportamiento	True
edición	True
asamblea	False
musical	False
convertido	False
órgano	False
enemigo	False
inferior	False
amenaza	True
artístico	False
signo	False
cuidado	True
preparar	True
división	False
loco	False
bolsa	False
fin	False
colocar	False
muchacho	False
fotografía	True
audiencia	True
preocupación	True
opción	False
repetir	True
seco	True
actualidad	False
laboral	True
expresar	False
recoger	False
constitucional	False
acudir	False
requerir	False
leche	True
interesante	True
desear	False
individual	False
recibido	False
costumbre	False
añadir	False
regresar	True
parque	False
accidente	True
carga	False
informar	False
británico	False
lector	False
deportivo	True
decidido	False
categoría	True
banda	True
deporte	True
espectáculo	True
frecuente	False
explicación	False
dedicar	False
falso	False
importar	False
medicina	True
agencia	False
semejante	False
enfrentar	True
permanente	False
relativo	False
foto	False
simplemente	False
adquirir	False
aceite	True
situado	False
fig	False
género	True
inicial	False
cubierto	False
haber	False
margen	False
lluvia	True
posible	False
sorpresa	True
tensión	False
huelga	True
prácticamente	False
imponer	True
alianza	True
publicado	True
gobernador	True
manifestar	True
tomado	False
recién	True
fórmula	False
habitante	True
conclusión	False
ausencia	False
denuncia	True
concepción	False
daño	False
escaso	False
dimensión	False
gol	True
llevado	False
compra	False
grito	True
efectivo	True
concluir	False
frontera	True
madera	True
elegido	False
gritar	True
solicitar	False
velocidad	True
argumento	True
acontecimiento	False
contribuir	False
tamaño	False
pecho	True
jardín	True
tío	False
regla	True
estatal	False
temor	True
letra	True
construir	True
independencia	True
hombro	True
impresión	False
esencial	True
salón	False
célula	True
probablemente	False
revelar	False
mejorar	False
martes	True
obligación	True
supremo	False
enseñanza	True
formado	False
cliente	True
insistir	True
ruido	True
posteriormente	False
cocina	True
máquina	True
misión	True
interpretación	False
síntoma	True
igualmente	False
protagonista	True
acompañado	False
estación	False
montaña	True
reina	True
parecido	False
identidad	False
aparte	False
hacienda	False
encargado	False
experto	True
anual	False
significativo	False
enviar	True
auténtico	True
olvidar	True
contestar	False
partida	False
canción	False
acompañar	False
unido	False
revolucionario	True
disco	True
pacto	True
funcionamiento	True
pintor	False
comprobar	True
reserva	True
aparición	False
excepción	False
registro	True
sustancia	True
protesta	True
sección	True
ideal	False
existente	False
incremento	True
liga	True
costo	True
lectura	True
componente	False
católico	False
distribución	False
suma	True
aprender	False
avance	False
sede	True
plata	True
liberal	False
estadounidense	True
jueves	True
portavoz	True
crítico	False
concentración	True
publicar	True
bello	False
huevo	True
incluido	True
punta	False
situar	False
continuación	False
confirmar	False
dado	True
chico	False
gas	True
obrero	False
federación	False
bien	False
asistir	False
fe	True
romper	True
lanzar	True
índice	True
preparado	True
ser	True
interesar	False
filosofía	True
marino	True
colombiano	False
introducir	False
amar	False
luna	False
facultad	False
postura	False
asesinato	False
virtud	False
excelente	False
presentación	True
comprar	True
ayudar	True
discusión	False
significado	False
localidad	False
acaso	False
acuerdo	True
búsqueda	True
crimen	False
occidental	True
vaso	False
testigo	True
socio	False
cuello	True
espejo	True
resolución	True
meter	False
labio	True
guardar	True
indio	False
ciclo	True
logrado	False
cita	False
notable	False
matrimonio	True
cristiano	True
compuesto	True
código	False
generalmente	False
caída	True
barco	True
desarrollado	False
misterio	False
convenio	False
creado	False
faltar	False
porcentaje	False
controlar	False
intervenir	False
acercar	False
nacido	False
reducción	False
culpa	True
sentado	False
batalla	True
comentario	True
mental	False
miércoles	True
pregunta	True
espectador	False
colaboración	True
mente	False
sentencia	True
educativo	True
consideración	False
múltiple	False
coincidir	False
chileno	True
decreto	True
recuperar	False
pasión	False
dueño	True
obligar	False
establecimiento	False
únicamente	False
entrega	False
asumir	False
triste	True
vuelto	False
intenso	False
desconocido	False
hermoso	True
literario	True
funcionar	True
plan	False
juventud	False
caliente	True
campesino	True
pendiente	True
organizado	False
inicio	True
inmediatamente	False
círculo	False
paisaje	False
automóvil	True
rueda	False
femenino	False
publicación	True
firme	False
equilibrio	True
ruso	True
presidencial	False
aprovechar	False
sencillo	True
ocurrido	True
integración	False
perfectamente	False
útil	True
desaparecer	True
recuperación	True
ánimo	True
calificar	True
composición	True
perfecto	False
petición	True
hogar	True
sonrisa	True
chica	True
fruto	False
preso	True
mandar	False
claramente	False
vuelo	False
tabla	False
terrorista	False
horno	False
depresión	True
policial	False
cuenta	False
peligroso	False
patria	False
corrupción	True
belleza	True
prisión	False
especialista	False
cadáver	True
auto	False
autónomo	True
sindical	False
esquema	False
conservar	True
papá	False
rasgo	False
plato	False
segundo	False
admitir	False
relato	False
tráfico	True
transformación	True
ordenar	True
modificación	True
potencia	True
atentado	False
azúcar	False
reflexión	False
pista	False
agregar	False
interesado	False
realización	False
gobierno	True
muchacha	False
clínico	False
resistencia	False
coronel	False
reconocimiento	False
universal	False
playa	True
observación	True
investigador	True
despertar	True
moneda	True
concierto	True
alegría	True
religión	True
silla	True
ejemplar	False
poesía	True
salario	True
seguramente	False
caminar	True
generar	False
fijar	True
municipio	True
clima	True
mando	True
conseguir	False
publicidad	False
eficaz	False
nervioso	False
alcance	True
capitán	True
puente	True
brillante	True
latino	False
garantía	False
torre	True
sexo	False
ganado	False
cooperación	False
productor	True
radical	False
universitario	False
planeta	True
preferir	True
utilización	False
apertura	False
anuncio	False
solidaridad	False
sometido	False
mencionado	False
encontrado	False
consciente	False
americano	False
obtenido	False
tren	True
cultivo	True
atender	False
senador	True
dulce	True
conseguido	False
telefónico	False
acusación	True
emoción	True
liberación	True
capa	False
rama	False
acusado	True
lento	False
escala	False
disciplina	False
conde	True
renunciar	False
alcohol	True
cubrir	False
extraordinario	True
consulta	True
contexto	True
curioso	False
diplomático	True
juzgado	False
rival	False
exportación	True
exceso	True
raro	True
borde	False
avanzar	False
hambre	True
regular	False
retirar	False
elaboración	False
débil	False
costar	False
tranquilo	False
vicepresidente	True
tía	True
pausa	True
aventura	True
bastar	False
hueso	True
proceder	False
alternativo	False
columna	True
paro	False
intensidad	True
exigencia	True
madrugada	False
rápidamente	False
invitado	True
poema	False
símbolo	False
desnudo	False
entorno	False
registrar	False
incorporar	False
motor	True
tiro	False
proporción	True
amarillo	True
cristal	False
amistad	True
procedente	False
turismo	True
impulso	True
cantar	False
aclarar	False
meta	True
ajeno	False
editorial	True
viajar	False
dominio	False
presunto	False
ensayo	True
nuevamente	False
reducido	True
núcleo	True
coger	False
completamente	False
madrileño	True
propietario	True
recientemente	False
roca	False
dependencia	True
elegir	False
despacho	False
salvar	True
variedad	False
adoptar	False
tienda	True
conservador	True
organizar	False
dibujo	True
mezcla	False
periodo	True
geografía	True
entregar	False
moda	False
festival	True
colonia	False
taza	True
coste	True
príncipe	False
seno	True
apartado	False
rechazar	False
mejora	False
terrible	True
usuario	True
traje	False
ilusión	False
productivo	False
nuclear	True
secretaría	True
ácido	False
tejido	True
gubernamental	False
convenir	False
gana	False
honor	False
placer	False
continuo	False
infantil	False
griego	True
escalera	True
analizar	True
diente	True
consejero	True
variable	False
terminado	False
amiga	False
fiel	False
evidencia	False
instrucción	False
inmenso	False
favorable	False
totalidad	True
aprobado	False
anciano	False
agricultura	True
contemporáneo	False
lesión	True
emisión	False
inteligencia	False
baño	True
bandera	True
vital	True
apuntar	False
olor	True
cerebro	True
preparación	False
basado	False
abuelo	False
risa	True
botella	True
bomba	False
obispo	True
global	True
informativo	False
absolutamente	False
contemplar	False
instancia	False
polvo	False
humor	True
enfrentamiento	False
conformar	False
naturalmente	False
fracaso	True
ceremonia	True
soviético	False
creciente	False
efectuar	False
violento	False
caracterizar	False
fila	False
delegado	False
regreso	False
proteína	True
déficit	True
quitar	True
suave	False
valer	False
solar	True
reconocido	False
diseño	True
suceso	False
galería	True
cumbre	True
correcto	False
testimonio	True
potencial	False
provincial	True
merecer	False
planteamiento	False
fundamentalmente	False
gloria	False
compartir	False
universo	True
escanda	False
alteración	False
secundario	False
definitivamente	True
teórico	False
extender	False
concesión	True
prima	True
recorrido	True
bloque	True
ejercer	False
llorar	False
oreja	True
comunicado	True
derrota	True
colección	True
amante	True
cierre	True
lejano	False
combate	True
definición	True
escolar	False
retrato	False
ambiental	True
formal	True
dosis	False
exclusivamente	False
embajador	True
muro	True
idioma	False
rodilla	False
inflación	True
residencia	False
soledad	True
eficacia	True
respectivamente	False
garantizar	False
rural	True
impacto	False
peruano	True
tender	False
fábrica	True
facilidad	True
ocupado	True
denominado	False
exactamente	False
autonomía	False
comentar	False
nacionalista	True
agrícola	False
especializado	False
eje	True
celebrado	False
asistencia	False
líquido	True
probable	True
duración	False
defensor	True
petróleo	False
invierno	False
laboratorio	True
tecnológico	False
encuesta	True
venezolano	True
nacimiento	True
pedido	False
preocupar	False
nariz	True
kilo	False
inútil	True
extensión	False
bar	True
tesis	True
afirmación	True
desaparecido	True
pantalla	True
paseo	False
administrativo	False
facilitar	False
implicar	False
ideológico	False
atractivo	True
visitar	False
cálculo	False
ejecución	True
episodio	False
incidente	False
oy	False
químico	False
plantear	False
tirar	False
imperio	True
convencido	True
ruta	False
imaginación	True
estabilidad	True
castellano	False
adolescente	True
tarjeta	True
orgullo	True
músico	True
reflejar	False
sonreír	False
reflejo	True
fruta	False
emisora	False
limpio	True
visitante	True
condenado	False
abundante	False
distrito	False
claridad	False
estímulo	True
redacción	True
solicitud	True
canto	True
estético	False
empresarial	False
novedad	False
cura	False
beber	False
hierro	False
riqueza	True
grasa	True
sonar	False
senado	True
promedio	False
temporal	False
cometido	False
patio	True
otan	True
tropa	False
consumidor	True
nube	False
mencionar	False
integrado	True
académico	False
hipótesis	True
sólido	True
cruzar	True
árabe	True
músculo	True
orquesta	True
monte	False
diagnóstico	False
expectativa	False
rechazo	False
colega	True
pesado	False
ilegal	True
limitar	False
restaurante	True
respectivo	False
supuesto	False
romano	True
excesivo	True
institucional	False
sacerdote	True
retirado	True
distinguir	True
progreso	True
remedio	True
vegetal	False
piloto	True
fortuna	True
aeropuerto	True
abuela	False
marcado	True
camión	False
rendimiento	True
templo	True
adulto	False
republicano	True
subrayar	False
sanción	True
difusión	True
cucharada	True
mantenimiento	False
latinoamericano	False
estrecho	True
pobreza	True
bolsillo	False
prestigio	False
patrón	False
transición	True
uniforme	True
cumplimiento	True
cantante	True
gris	True
pensión	True
avenida	False
lentamente	False
satisfacción	True
medicamento	False
mentira	True
paquete	False
viaje	True
dictadura	True
comunitario	False
salto	True
vigente	False
indígena	False
cáncer	True
hilo	True
descenso	False
entusiasmo	True
ideología	True
recuerdo	False
iniciado	False
variación	False
explotación	False
manejo	True
judío	True
imaginar	True
asiento	True
aprobación	True
aprobar	False
acusar	True
luchar	False
representado	False
conveniente	False
mediado	False
candidatura	True
rumor	True
acordar	False
torneo	False
parcial	True
universidad	True
enseñar	True
polémica	False
particularmente	False
atmósfera	True
pasillo	True
descubierto	False
conductor	True
estadio	False
infección	True
efectivamente	False
circulación	True
separar	False
sospecha	False
aficionado	True
rincón	False
campeón	False
manifiesto	False
feria	True
exponer	False
trato	False
trastorno	False
taller	True
hábito	False
sanitario	False
ingrediente	False
humanidad	True
fácilmente	False
conceder	True
poderoso	False
infancia	True
sensible	False
obstáculo	False
rayo	True
pasado	False
rumbo	False
verso	True
ejemplo	True
decisivo	False
legislación	False
plástico	True
magistrado	False
limitación	False
campeonato	True
operar	False
tela	False
demostrado	False
justificar	False
pájaro	False
promesa	True
sierra	False
alimentación	True
esquina	False
expansión	False
exclusivo	False
vacaciones	False
alcanzado	False
clasificación	False
reloj	True
banca	False
concejal	True
ingeniero	True
corredor	True
arena	True
anteriormente	False
comandante	True
cotidiano	False
contradicción	True
homenaje	True
gravedad	True
limitado	False
importación	True
espectacular	False
mero	False
baja	True
litro	False
sensibilidad	False
lágrima	False
estancia	True
héroe	True
profundidad	False
emitir	False
anunciado	False
autonómico	False
disminuir	True
expediente	False
tabaco	True
renta	True
concurso	False
nave	False
angustia	False
directivo	False
restante	False
terrorismo	True
cigarrillo	True
trasladar	False
sacrificio	True
evaluación	True
felicidad	True
modalidad	False
oscuridad	True
aportación	False
culpable	True
describir	False
virus	True
caballero	True
incapaz	True
previamente	False
combinación	False
partidario	False
destacado	False
permiso	True
vivido	False
cena	False
raza	True
ampliación	False
noble	False
sufrido	False
fino	False
orilla	False
teniente	False
viajero	True
vencer	False
equivalente	False
corona	False
incendio	True
llave	True
dignidad	False
depósito	True
crónica	False
docente	False
fantasma	True
defecto	False
biblioteca	True
militante	True
humo	True
firmar	False
espacial	False
ancho	True
cartel	False
cuerda	False
cuota	False
fresco	False
precisar	False
ópera	True
continuidad	True
cualidad	False
pantalón	True
cuadrado	True
tonelada	True
igual	False
dama	False
gen	True
comprensión	False
metal	True
logro	True
convocatoria	True
profesión	True
regalo	True
plante	False
entrenamiento	True
requisito	False
gato	False
bebida	False
coalición	True
descanso	True
promoción	True
aprendizaje	True
identificar	False
continente	True
tarifa	False
síntesis	True
ligero	True
evento	True
arquitectura	True
visible	False
aislado	False
integrante	False
mineral	False
orientación	True
destrucción	False
bancario	False
primavera	True
confusión	True
huella	True
proporcionar	False
financiación	True
panorama	False
guerrillero	False
permitido	True
relativamente	False
disponible	False
celebración	True
ordenador	True
disparo	True
anoche	False
cabello	True
disminución	False
vinculado	False
separado	False
oculto	False
inquietud	True
afuerar	False
milagro	True
curiosidad	True
mediodía	True
arco	True
circuito	False
placa	False
creador	False
absurdo	False
ernesto	False
embajada	True
patrimonio	True
proteger	False
mérito	False
juvenil	False
fantasía	True
construido	False
carecer	False
onda	False
palma	False
adelantar	False
sueldo	False
centenar	True
compositor	True
desaparición	True
colaborador	False
gira	False
aéreo	False
sumar	True
precedente	True
maniobra	False
semilla	True
aceptado	False
investigar	True
cinta	True
temer	False
criminal	False
genético	False
pensado	False
programación	True
prever	False
estable	True
durar	False
definido	False
sorprender	False
integrar	False
inocente	True
dios	True
aliado	False
estructural	False
conexión	True
cobrar	False
mandato	True
mapa	False
creencia	True
oriental	False
verdadero	False
beso	True
suficientemente	False
consenso	True
necesariamente	False
eterno	True
fama	True
casado	True
emperador	True
mecánico	True
intérprete	True
curva	False
harina	True
aportar	False
igualdad	False
avanzado	True
varón	False
pecado	True
sabor	True
oeste	True
posesión	False
vídeo	False
pata	False
delegación	False
mito	False
bolívar	True
fundamento	False
israelí	True
lateral	False
copia	False
carro	True
setenta	False
agresión	True
leve	False
legislativo	False
reglamento	False
suizo	False
primario	False
vigor	False
lujo	False
corresponsal	True
asesino	False
percepción	True
león	True
fijo	False
ala	True
perro	True
rigor	False
recorrer	False
escultura	True
estadística	True
plaza	True
prestar	True
digno	False
ubicado	False
vigilancia	True
excepcional	False
sucedido	True
dominante	False
archivo	True
esencia	False
variado	False
rebelde	True
exacto	True
geográfico	False
bonito	False
eliminar	False
brasileño	False
guerrilla	False
interpretar	False
trámite	True
medir	False
adicional	True
marcar	False
tramo	False
horario	False
trozo	False
dormido	False
cortar	True
denunciar	True
caído	False
visual	True
dieta	True
firmado	False
comerciante	True
asesor	False
narcotráfico	False
asistente	False
xx	False
dinámica	False
arquitecto	True
apreciar	True
electrónico	False
siquiera	False
préstamo	True
turno	False
manejar	False
constituido	False
calma	True
intercambio	True
conservación	True
combustible	True
enviado	True
odio	True
olvidado	False
pescado	True
examen	False
gobernante	True
abuso	True
registrado	False
jugado	False
zapato	False
multitud	False
precisión	True
monetario	True
rodear	False
imprescindible	False
revisión	False
gota	False
artificial	True
baile	True
secuencia	True
aporte	True
derivado	True
entrenador	True
esfera	True
ángulo	False
verdaderamente	False
queja	True
complicado	True
estimar	False
ave	True
previsión	False
profundamente	False
danza	True
ética	True
ruptura	True
identificación	True
castigo	True
percibir	True
mortal	False
tel	False
sucesivo	True
separación	True
herramienta	True
perfil	True
recto	True
apariencia	True
respaldo	False
masculino	True
península	True
violación	True
pacífico	False
horizonte	True
bienestar	True
ciego	True
vitamina	True
párrafo	True
aparentemente	False
condena	True
lección	False
detención	True
camisa	True
tragedia	True
aspiración	False
japonés	True
transformar	False
alternativa	True
comparación	True
tve	True
rodeado	False
sustituir	True
masivo	False
favorecer	True
desgracia	True
privilegio	True
participante	True
voluntario	True
ciertamente	False
sano	False
contaminación	True
íntimo	False
terrestre	False
elevar	False
ligeramente	False
humedad	True
inconveniente	True
queso	True
grano	False
autobús	True
medalla	False
ola	False
tristeza	True
lado	False
delicado	False
vergüenza	False
opuesto	False
fibra	False
infinito	False
socialismo	True
satélite	True
pluma	False
trayectoria	True
secuestro	True
diablo	True
inevitable	False
cebolla	True
suspensión	False
alza	False
descripción	False
finalidad	False
tomate	True
actriz	True
expuesto	False
cola	False
posiblemente	False
amparo	True
provocado	False
prioridad	False
maíz	True
mancha	False
infraestructura	True
urgencia	False
tranquilidad	True
progresivo	False
xviii	False
torero	True
causar	True
experimento	True
sexto	True
nieve	True
funcional	False
atravesar	False
terror	False
ap	False
incorporación	True
antecedente	True
grueso	False
negociar	False
bosque	False
típico	False
vocación	False
observador	True
piano	True
normalmente	False
instalado	True
granada	False
intento	True
receptor	True
licencia	False
pasajero	False
balance	False
ganancia	False
plenamente	False
domicilio	True
aceptación	False
dramático	False
km	False
adiós	True
fotógrafo	True
oriente	False
votación	False
titulado	False
divisa	False
elemental	False
gordo	True
agudo	False
emergencia	True
subida	False
premio	False
quinto	False
componer	False
singular	False
pelota	True
parar	False
preferencia	True
convivencia	False
mina	True
guía	False
ansiedad	True
barrera	True
inteligente	True
ruina	False
novio	True
acceder	True
olvido	True
transferencia	True
talento	True
evidentemente	False
sucio	False
poético	False
vanguardia	True
magnífico	False
cm	True
casco	True
invitar	True
considerable	False
cero	False
dominar	True
desierto	True
exilio	True
pretensión	False
psicológico	True
propuesto	True
espiritual	True
aplicado	False
adaptación	True
botón	False
contraste	True
adentro	False
vela	False
desempleo	True
otorgar	False
perteneciente	False
prestación	False
izquierdo	False
salsa	True
fragmento	True
represión	False
tesoro	False
et	False
pedazo	False
locura	False
transmitir	False
recomendación	True
modificar	True
comisario	False
buque	True
novia	False
caza	True
proyección	True
combatir	False
doctrina	True
ingresar	False
abandono	False
urss	False
filósofo	True
explosión	False
renovación	True
llenar	False
muscular	False
química	True
transmisión	True
variar	False
corporación	False
billete	True
estricto	False
usado	False
determinación	True
convencional	True
pez	True
rapidez	True
sombrero	True
estómago	True
parado	False
paciencia	False
ronda	False
escapar	False
debilidad	True
miseria	True
indispensable	True
sugerir	False
otoño	True
montar	True
ocupación	False
magnitud	False
generalizado	False
corrida	False
biológico	False
acá	False
minoría	True
fusión	True
recogido	False
limpieza	False
prometer	False
herencia	True
pilar	True
paralelo	False
misa	True
cariño	False
deterioro	False
utilidad	False
culto	False
calcular	False
soberanía	True
abandonado	False
aniversario	True
turista	False
tránsito	False
incidencia	False
vigencia	True
gráfico	False
aparente	False
saltar	False
afán	False
documentación	True
prisa	False
personalmente	False
jurado	True
legislador	True
sagrado	True
recurrir	False
conquista	False
escritura	False
comando	False
costado	False
regulación	False
oficialmente	False
relevante	False
historiador	True
convicción	True
ucd	False
mercancía	False
finanzas	True
introducción	True
turístico	False
hallazgo	True
reclamar	True
esposo	True
discutir	True
declarado	True
retorno	False
pistola	True
gerente	True
cómodo	True
planificación	True
brusela	False
constantemente	False
censura	True
art	False
manzana	False
resumen	True
mágico	False
nombrado	False
maravillo	False
energético	False
movilización	True
nicaragüense	False
enfoque	False
corporal	False
reparto	False
sumamente	False
agrupación	True
síndrome	False
diversidad	True
coordinación	True
balón	True
relieve	False
urgente	False
pasaje	False
gramo	True
mueble	False
variante	True
promover	False
salvaje	False
burguesía	False
viuda	True
móvil	True
centímetro	True
vínculo	False
rubio	False
fiebre	True
acostumbrado	False
longitud	True
moderado	False
circular	False
cartera	True
ajuste	True
vientre	True
andaluz	True
soportar	True
extenso	True
fuga	False
mensual	True
metido	True
convocado	False
adquisición	True
vidrio	True
monumento	True
sorprendente	False
respiración	False
resistir	True
adn	True
elaborado	False
ajo	True
basar	False
provenir	False
integral	True
solitario	True
pronunciar	False
fallo	False
recinto	True
directiva	False
agradable	True
nombramiento	True
húmedo	False
indígeno	False
fabricación	True
señorita	False
india	True
comicio	False
xvii	False
autorización	True
traslado	False
boda	True
caldo	True
embarazo	True
molécula	True
casar	False
monarquía	True
molesto	False
hierba	False
habilidad	True
ahorro	True
divino	False
cintura	False
cinematográfico	False
reservado	False
basura	False
alicia	False
miel	True
asociado	False
cerveza	True
mediano	True
ampliar	True
públicamente	False
esclavo	True
infierno	True
foco	True
tremendo	False
sillón	True
eliminación	False
convocar	False
té	True
civilización	True
válido	False
valoración	False
certeza	False
demócrata	False
justamente	False
récord	True
doméstico	False
limón	True
refugio	True
libra	True
constar	False
deficiencia	False
oxígeno	True
complejidad	True
sustitución	True
prolongado	False
reivindicación	False
azar	False
nervio	False
confesar	True
prisionero	False
demonio	True
recepción	False
figurar	False
propaganda	True
calendario	True
aliento	False
significación	False
inspector	False
bala	True
usar	False
ascenso	True
manera	False
guión	False
retraso	True
leyenda	False
dimisión	False
mejilla	False
eco	True
revés	False
fundado	True
americana	False
admiración	True
comunicar	True
publicitario	False
instalar	False
estrictamente	False
plantilla	True
mariano	False
disfrutar	False
perfección	False
cancha	True
vendedor	True
mierda	False
romántico	False
encargar	False
crema	True
enterar	False
repercusión	False
denominar	False
decena	False
toque	False
carbón	True
rito	False
cobertura	False
padecer	True
favorito	False
alegre	True
soporte	False
gozar	False
montaje	False
ofensiva	True
espada	False
racional	True
invasión	True
puta	False
sucesión	False
acumulación	True
afición	True
entendido	False
trimestre	True
receta	False
presidido	True
consejo	True
rango	False
increíble	True
partir	False
disparar	True
inesperado	True
africano	True
cementerio	True
creativo	True
hielo	True
prevención	True
transcurso	False
frecuentemente	False
rock	False
confiar	False
aviso	False
asalto	False
supervivencia	False
perdón	False
atento	False
selva	True
satisfacer	False
distinción	True
falla	False
canciller	False
dispositivo	True
reto	True
refugiado	True
fraude	False
orgánico	False
seleccionado	False
fiscalía	True
capitalismo	True
ligado	False
sorprendido	False
cansancio	True
inicialmente	False
normativa	False
discípulo	True
rabia	False
reproducción	True
célebre	False
roto	False
seguimiento	False
intimidad	False
doloroso	False
cuenca	False
drama	True
consumir	True
criticar	False
colonial	False
básicamente	False
filme	False
adquirido	False
dorado	False
densidad	True
cuartel	False
cuento	False
prenda	False
adversario	False
barro	True
asesinado	False
llama	False
trágico	False
quinta	True
entendimiento	False
afrontar	False
barra	True
tumba	True
procesado	False
correo	False
hectárea	True
pasta	False
simultáneamente	True
probar	False
almuerzo	True
bahía	True
vano	False
primitivo	False
horror	True
seguidor	False
permanencia	False
pelea	False
prd	False
dormitorio	True
redondo	False
habitualmente	False
incertidumbre	False
listo	False
sonoro	False
privatización	True
elegante	False
and	False
comedor	True
peculiar	False
simbólico	False
teatral	False
tronco	True
empeño	False
repetido	False
influir	True
tercio	True
irregularidad	False
alejar	False
kg	False
vapor	False
razonable	False
propiamente	False
quibir	False
ganador	False
incapacidad	True
invitación	True
choque	True
garganta	True
productividad	True
robo	True
elaborar	True
asombro	True
respetar	False
bailar	True
bosnia	True
tarde	True
estratégico	False
almacén	True
manteca	False
censo	True
aislamiento	False
manolo	False
juzgar	False
nocturno	False
optar	False
jugo	True
enmienda	True
amanecer	True
huir	True
notar	False
genio	True
satisfecho	True
atlántico	True
tentación	False
entregado	False
secretaria	True
costa	True
severo	False
indicación	False
inés	False
provisional	False
empate	True
alarma	True
cuchillo	True
oral	False
trama	True
referente	False
giro	True
presa	False
parto	False
supuestamente	False
noción	False
directora	True
futbolista	True
cuero	True
ciudadanía	True
cocción	True
modo	False
sabiduría	False
preocupado	False
maldito	True
problemática	False
acento	True
indiferencia	True
helicóptero	True
desastre	False
fundar	False
reuter	False
citar	False
sudor	True
idéntico	False
ficción	True
ocultar	True
comedia	True
cortina	True
desesperado	True
manifestado	False
fachada	True
monto	False
inspiración	False
ternura	False
cansado	False
estallar	False
reír	False
planteado	False
desesperación	True
accionista	True
montón	False
tocado	True
nacionalidad	False
sufrimiento	True
votar	False
cerro	False
broma	False
afecto	True
rol	False
alba	True
suicidio	True
vertical	True
mandatario	False
psicología	False
correspondencia	True
pesca	True
marchar	False
electricidad	False
bebé	False
coro	True
postre	True
filosófico	False
asilo	True
alcaldía	False
colocado	False
contento	False
hueco	True
flujo	False
bordo	False
obtención	False
peor	False
endor	False
solucionar	True
delincuente	True
capitalista	False
mutuo	False
informado	True
film	False
caos	False
desafío	False
territorial	False
tormenta	False
diana	False
finca	True
traducción	True
rosario	True
finalizar	False
fuertemente	False
contribución	False
ajenar	False
partícula	False
madurez	True
inmigrante	False
incrementar	False
confederación	True
inspección	True
celular	False
gobernar	True
cocaína	True
terapia	False
taxi	False
uso	False
ignorar	False
acero	True
importe	False
altamente	False
impresionante	False
moder	False
mediterráneo	False
agenda	False
picado	False
balcón	False
difícilmente	False
lecho	False
clarín	False
plataforma	False
sandinista	True
vegetación	False
fortaleza	True
ignorancia	True
cable	False
prado	False
persecución	True
saco	False
captura	False
abundancia	False
inauguración	True
implantación	False
optimismo	True
completar	True
malestar	False
ridículo	False
venganza	True
ampliamente	False
deriva	True
emocional	False
docena	False
centroamérica	False
arrancar	False
desprecio	False
convencer	False
énfasis	True
cobre	True
concretamente	False
mal	False
financiamiento	False
copa	False
diámetro	False
crudo	True
nostalgia	True
parcialmente	False
ministra	True
grabar	True
indicio	False
alrededor	False
rescate	False
referéndum	False
sobrevivir	True
competir	False
lago	False
casualidad	False
contratación	False
alivio	True
alerta	True
oportuno	False
residir	True
residuo	False
trascendencia	True
mortalidad	True
probabilidad	True
fidelidad	True
ausente	False
flota	False
simpatía	False
algodón	False
eficiencia	True
obvio	False
estreno	False
liderazgo	True
lanzamiento	True
operativo	False
primo	True
apellido	False
modernización	True
ironía	False
cruel	False
ofrecido	False
coordinador	True
bloqueo	False
aborto	True
puramente	False
nacionalismo	False
eventual	False
reagan	True
amable	False
billón	False
perjuicio	True
brillo	False
pañuelo	False
excesivamente	False
conducción	True
excelencia	True
expulsión	False
últimamente	False
cerebral	False
desorden	False
retiro	True
expresado	False
exclamar	False
carencia	False
hígado	True
acercamiento	False
cc	False
prohibición	False
normalidad	False
bronce	True
carbono	True
transparente	False
presidir	False
magia	True
disputa	True
destruir	False
cúpula	False
consolidación	False
inconsciente	True
respectar	False
podero	False
sencillamente	False
denominación	False
verbal	False
muchísimo	False
inmóvil	False
riego	True
conferencia	True
trago	False
credibilidad	True
seda	True
pretexto	False
firmeza	True
inocencia	False
escasez	True
ritual	True
indicado	False
coincidencia	True
rehén	False
tubo	True
colón	False
vaticano	True
continuamente	False
convento	True
cerdo	True
esencialmente	False
atribuir	True
llanto	True
desconfianza	True
desayuno	False
libremente	False
fijado	False
colaborar	False
seriamente	False
leir	False
aparecido	False
licenciado	True
antena	False
maestra	False
iglesia	True
tolerancia	True
competición	True
evaluar	True
validez	False
rentabilidad	True
marcador	True
abordar	False
atracción	True
prohibido	False
configuración	False
órbita	True
gama	False
creatividad	True
jacque	False
fujimori	True
cosecha	False
considerablemente	False
pagado	False
chocolate	True
despedida	False
superado	False
detectar	True
realismo	True
descansar	True
levantado	False
fumar	True
adhesión	True
ubicación	False
inseguridad	True
mm	True
cardenal	False
salarial	False
inclusive	False
aproximación	True
penumbra	False
sumario	False
trigo	True
experimentado	False
causado	False
transparencia	True
reposo	True
cenar	False
majestad	False
reconstrucción	True
formato	False
insuficiente	False
práctico	False
celda	True
residente	True
políticamente	False
pollo	False
fundador	False
imposibilidad	False
enferma	False
repertorio	False
repetición	True
revisar	False
gala	True
rector	True
diariamente	False
terraza	True
escritorio	True
esperado	False
jerusalén	True
enamorado	True
capilla	True
cerámica	True
prevenir	True
pico	False
pesadilla	True
suavemente	False
duelo	True
pánico	False
delantero	False
retórica	True
invisible	True
cirugía	True
indudable	True
designación	True
jerarquía	True
pusar	False
trampa	False
recomendar	False
protagonismo	False
antigüedad	False
justificación	False
fallecido	False
reiterar	True
específicamente	False
dureza	False
rebelión	True
corregir	True
aldea	False
conveniencia	False
expedición	True
breve	True
gasolina	True
crecido	True
pimienta	True
dictador	True
perejil	False
presidenta	False
realista	False
ceder	False
vinculación	False
serenidad	False
analista	True
reforzar	False
adopción	True
extradición	True
rehabilitación	True
aplauso	True
modernidad	True
empleo	False
áfrico	False
invertir	True
maquinaria	False
discriminación	True
semestre	True
legalidad	False
ambición	False
comunismo	True
fatal	False
marqués	True
frenar	True
tenis	True
gafas	True
insecto	True
lamentable	False
sargento	False
instinto	False
falda	True
envidia	True
inscripción	False
restricción	True
demostración	True
volar	False
mención	False
gigante	False
uña	True
espectro	True
averiguar	False
opinar	True
pulso	True
adolescencia	True
complicación	False
balanza	True
gallego	True
experimental	False
caña	True
constancia	False
manipulación	False
coherente	False
seriedad	True
portero	True
merced	False
patente	True
óptico	False
característico	True
radicar	False
jurisdicción	True
horizontal	False
asociar	False
financiar	False
captar	True
suelto	True
obsesión	True
palestino	False
confrontación	True
sucesor	True
horrible	False
agujero	False
reportaje	True
divorcio	True
menú	False
cuidadosamente	False
pescador	True
grandeza	True
emprender	False
tapa	True
árbitro	True
tregua	True
compañera	False
popularidad	True
surgido	False
urna	True
auge	False
tradicionalmente	True
barba	True
sofá	False
fresca	False
celo	False
biografía	True
matiz	False
independientemente	False
desprender	False
comprometido	False
inminente	False
princesa	True
apuesta	True
rosa	True
humilde	True
pce	True
salvación	True
eficiente	False
irregular	True
abiertamente	False
complicidad	False
amor	False
radiación	False
emplear	False
innumerable	False
insistencia	False
tour	True
furia	True
pauta	True
valorar	True
encargo	False
elector	True
cese	True
sed	True
abrigo	False
porvenir	False
salina	False
trayecto	False
lanzado	False
participado	False
armar	False
descrito	False
ira	True
corteza	True
parámetro	True
comprendido	True
preferido	False
prudencia	False
equivaler	False
liberalismo	True
impulsar	False
verdura	False
unanimidad	True
mantequilla	False
sello	True
caro	False
injusticia	False
saldo	True
ríe	False
calcio	True
conocí	False
arzobispo	True
interacción	True
proveniente	True
cargado	False
restauración	True
túnel	True
implicado	False
deseado	False
papas	False
pariente	False
comercialización	True
rutina	False
integridad	False
correctamente	False
timbre	False
monopolio	False
pc	True
competitividad	True
torno	True
alusión	False
aprovechamiento	False
coherencia	False
respirar	False
designado	True
atacar	False
mentalidad	False
impotencia	False
sostenido	True
plenitud	True
anterioridad	False
escaño	False
conjuntamente	False
transcurrir	False
proposición	False
consultar	False
rtve	False
especialidad	False
fallecer	True
esplendor	False
joya	True
narración	True
manual	False
juro	False
enlace	False
marxista	True
vinir	False
pta	False
documental	True
dotado	False
altar	False
porción	True
practicar	False
bono	False
exactitud	False
apartamento	False
progresivamente	False
envío	False
catedrático	False
sobra	True
narrativa	True
doler	False
amplitud	False
abarcar	False
bola	True
procedencia	False
ordenado	False
extinción	True
veras	False
adecuadamente	False
sentimental	False
buscado	False
frustración	True
trazado	False
talla	False
ingenio	False
tim	False
atardecer	True
ejecutar	False
colocación	False
duque	True
advertencia	False
engaño	True
dependiente	True
exploración	True
hondo	False
comir	False
optimista	False
interminable	False
dedicación	True
saludo	False
agricultor	True
excusa	False
bota	False
lana	True
pozo	True
plomo	False
inversor	False
comarca	False
debido	False
cuidar	True
lástimo	False
víspera	True
legitimidad	True
elegancia	False
cometer	False
dictamen	False
proximidad	True
lazo	False
quiebra	False
brutal	False
consiguiente	False
acierto	False
legislatura	True
tortura	False
administrador	False
saint	False
moción	False
culo	False
agrario	False
conformidad	False
abrazo	True
umbral	False
borracho	False
traición	True
cucharadita	False
exhibición	False
consistente	False
franquismo	True
efectividad	False
notablemente	False
lingüístico	False
nuca	False
parada	False
confirmado	False
reestructuración	False
conversión	False
niebla	True
whisky	True
terminal	False
obviamente	False
superioridad	True
supresión	False
inestabilidad	True
revelación	False
metáfora	False
decoración	False
negado	False
natal	False
identificado	False
holandés	False
prudente	False
recuperado	False
aroma	False
capacitación	False
musulmán	False
sabio	False
fármaco	False
organizador	False
absorción	True
decadencia	False
superficial	False
manifestante	True
cemento	True
lavado	False
solemne	True
intermedio	False
querella	False
pronóstico	True
lentitud	False
encanto	False
sutil	False
debidamente	False
inclusión	False
oración	False
equivocado	False
serbio	True
medellín	False
económicamente	False
portugués	False
catástrofe	True
entierro	True
cocinar	True
monstruo	True
fauna	False
pureza	False
elevación	True
aceptable	False
fatiga	True
indicador	False
sábana	False
lema	False
medieval	True
digital	False
hagar	False
flexibilidad	True
tenor	False
apetito	True
acogida	True
chaqueta	True
comprado	False
pa	False
colesterol	True
certamen	False
reunido	False
frágil	True
urbanización	True
factura	True
harto	False
amnistía	True
confesión	True
despliegue	False
cabecera	True
delirio	False
determinante	False
anécdota	False
volante	True
bacteria	False
divertido	False
cumpleaños	False
insomnio	True
táctica	True
subido	False
nobleza	False
penetración	True
subasta	True
suministro	False
lógicamente	False
melancolía	True
lapso	False
ferrocarril	True
acordado	False
huida	False
piedad	False
subsecretario	True
localización	False
automáticamente	False
clausura	False
escoger	True
heroína	True
campamento	True
leña	True
recaudación	False
mérida	False
vinagre	True
acta	True
mármol	True
corrección	False
cartón	True
creído	False
portada	True
potente	False
iluminación	False
limpiar	True
medianoche	True
efectuado	False
intuición	False
sexualidad	False
cd	True
zedillo	True
diputación	True
catálogo	True
escapa	False
indignación	False
octavio	False
concluido	True
vaca	True
desempeño	False
hongo	True
permanentemente	False
afiliado	True
piscina	True
patronal	True
traducir	False
pintar	False
disolución	False
perfume	True
coraje	False
palo	True
expresamente	False
extremadamente	False
implacable	False
arreglo	False
trono	True
xv	True
obedecer	True
corbata	False
conceptual	False
tardar	False
exámen	False
fortalecer	False
seña	False
olímpico	True
muñeca	False
movilidad	False
preguntado	True
vejez	True
generado	False
desfile	True
sistemático	False
informática	True
leonor	False
anualmente	False
cotización	False
fomentar	False
desenlace	False
coyuntura	False
grabación	False
consuelo	False
lámpara	True
estatura	True
penetrar	True
examinar	False
predominio	False
atenas	True
editor	True
cajón	True
barato	False
radicalmente	False
distante	True
delincuencia	False
alejado	False
sustancial	False
relevancia	True
aviraneta	False
ordenamiento	False
nombrar	False
fabricante	False
seminario	True
inversionista	False
macho	True
consolidar	False
baloncesto	True
calificación	True
seleccionar	False
ayudante	True
preferible	False
ocio	False
char	False
plantel	False
estimular	False
suspender	False
procesamiento	True
reflexionar	False
barroco	True
envuelto	False
cortado	True
complemento	False
ingeniería	True
meramente	False
muslo	True
ascender	False
matemático	True
tendido	False
hembra	False
formalmente	False
penal	True
monseñor	False
poblado	False
vulgar	False
invención	False
jazz	True
conspiración	True
subvención	True
maleta	False
concedido	False
matanza	True
insoportable	False
pálido	False
atleta	True
generosidad	False
complutense	False
primordial	False
requerimiento	False
apropiado	False
veterano	False
asegurado	True
rodaje	False
hegemonía	False
setiembre	False
imposición	True
naturalidad	True
océano	True
inclinación	False
rechazado	False
fomento	False
faena	False
monarca	False
feroz	False
valiente	True
dialéctico	False
rastro	True
cobro	False
pulmón	True
vacuna	False
vencedor	False
portal	True
devolver	False
bombero	True
oliva	True
dueña	True
ángel	True
vencido	True
perseguir	False
orina	True
disgusto	False
terremoto	False
televisor	True
abismo	True
puño	False
patata	True
cruce	False
lealtad	False
monja	True
mejoramiento	False
aspirante	False
mediación	True
lucir	False
filial	False
bruscamente	False
sospecho	True
paja	True
fracción	False
desconocer	False
colmo	False
formulación	True
bondad	True
procurador	True
haití	False
molestia	True
extraña	True
asunción	False
asco	True
golfo	False
rencor	False
reaccionar	False
preservar	True
anillo	True
interlocutor	False
diseñado	False
patología	False
sonriente	False
anselmo	False
estrato	False
terapéutico	False
sobrino	True
guerrero	True
prestado	False
compensación	False
extendido	False
japón	True
ladrillo	True
contundente	False
enfermera	True
electorado	False
comisaría	True
susto	True
girar	True
fabricar	True
american	False
mama	False
ayudado	False
desagradable	False
cristóbal	True
clic	True
prejuicio	True
comparecencia	True
abstracción	True
consistencia	False
previsible	False
arreglar	True
camilo	False
ente	False
cia	False
belga	True
legalmente	False
oponer	True
monasterio	True
degradación	False
vestir	False
transformado	True
motivación	True
indiferente	False
cuna	False
bandeja	False
bruto	False
autora	False
anti	False
trance	True
poblador	False
porqué	False
injusto	False
sonrer	False
latín	True
inevitablemente	False
denunciado	False
incorporado	False
encerrado	False
contrabando	False
metodología	True
levantamiento	True
proso	False
eternidad	True
probado	False
indiscutible	False
sal	True
naval	True
átomo	False
articulación	True
impunidad	True
relevo	False
modesto	False
inmigración	True
euforia	False
agresividad	False
grabado	True
picada	False
muelle	False
balear	False
comparar	False
resultante	False
coca	False
azulgrana	False
ladrón	True
conquistar	False
atraer	False
devoción	False
laberinto	True
disponibilidad	True
puñado	False
che	False
extraer	True
pasaporte	True
supervisión	True
ramo	True
centavo	True
interrumpir	True
pinta	False
contienda	False
manta	True
medina	False
exclusión	True
narrador	True
recorte	False
aristótel	False
rotación	True
clemente	False
ordenación	True
instrumental	True
sucesivamente	False
procesión	True
sopa	True
corta	False
vestuario	False
cima	False
adoptado	False
admirable	False
armamento	False
chimeneo	False
descarga	True
apoyado	False
aspirar	False
telecomunicación	False
recipiente	False
orlando	True
pintado	False
total	True
conllevar	False
bolso	False
ida	False
confirmación	False
convención	False
niñez	False
goma	True
sumo	True
armario	True
sarajevo	True
continental	False
genial	False
invento	False
caridad	False
ceniza	True
soñar	False
compás	True
objetividad	True
negación	False
desequilibrio	True
originar	False
pabellón	False
inverso	False
novelista	True
comodidad	True
etarra	False
entraña	False
antepasado	True
reelección	True
alquiler	True
dividido	False
alterar	True
multa	True
verdad	False
camiseta	True
profundizar	False
siniestro	False
añadido	False
psicosis	True
uruguayo	False
razonamiento	True
roque	True
temática	False
marxismo	True
descartar	False
recomendable	False
llamamiento	False
siembra	True
mare	False
cuantía	False
remate	False
diferencial	False
vena	True
lata	False
estatuto	False
confundir	False
formular	False
aguantar	False
votante	True
replicar	False
salí	True
molde	True
autopista	False
imagino	False
derrotado	False
verter	False
jubilación	True
conversar	True
ario	False
desconcierto	False
pekín	True
prólogo	False
ratón	False
espontáneo	False
defensivo	False
cráneo	True
gravemente	False
mejoría	False
cristianismo	True
relleno	True
tinta	True
franja	False
párpado	False
gratuito	False
dividir	True
literalmente	False
nomás	False
auditorio	False
sinceridad	False
ajedrez	True
embarazado	False
físicamente	False
burlar	False
almirante	True
imaginario	False
competente	False
miserable	False
discreción	False
diferenciación	True
pianista	True
consigna	False
semejanza	False
deportista	True
matrícula	True
agonía	False
pronunciado	False
parroquia	True
extracción	True
proyectar	False
anotar	False
curación	True
manto	True
fijación	False
especulación	False
innovación	False
feo	False
provecho	False
burocracia	False
preferentemente	False
patrocinio	False
suscrito	False
sustancialmente	False
delgado	False
irme	False
expulsado	True
compartido	False
valía	False
cercanía	True
ético	False
jamón	True
segmento	False
centrar	True
operador	True
retroceso	False
pesar	False
matriz	True
caudal	False
virtual	True
gallina	False
nuboso	False
misil	True
controlado	False
suspendido	False
abstracto	True
maravilla	False
paulatinamente	False
esclavitud	True
superación	False
generoso	False
riguroso	False
biblia	True
insuficiencia	False
escudo	True
serrano	False
curar	False
reparación	False
escondido	False
intensamente	False
nieto	True
bestia	True
concretar	False
disimular	False
sodio	False
voluntariamente	False
preocupante	False
multinacional	False
freno	True
homicidio	False
hervir	False
heredero	True
indemnización	True
séptimo	False
profesorado	False
canela	True
paradoja	True
inventado	False
sencillez	True
compensar	False
excitación	False
caloría	True
estrés	True
homosexual	True
protegido	False
temía	False
afueras	False
diligencia	True
descender	False
hispano	True
celeste	True
borrar	False
quehacer	False
álbum	False
temprano	False
relacionar	False
involucrado	False
arranque	False
cómplice	True
bail	False
deseable	False
inquietante	False
legítimo	False
feto	True
industrialización	True
captación	False
acera	True
melodía	True
ordinario	False
narcotraficante	True
navegación	True
robado	False
iniciación	False
brigada	True
potable	False
precaución	True
inaugurar	False
pegar	True
gestación	False
fianza	True
toreo	False
presuntamente	False
centenario	True
dotación	False
monumental	False
ilustre	False
reparar	False
consecución	False
doctora	False
ecuación	True
mitin	True
esconder	False
detectado	False
minero	True
espíritus	False
rescatar	False
tomo	False
agotado	False
procuraduría	True
dudar	True
proporcional	False
decirtir	False
pasear	False
desigual	False
telón	False
cuaderno	True
sospechar	False
mono	False
cirujano	True
vitalidad	False
vicio	False
yema	True
utopía	False
valioso	False
mutuamente	False
dijistir	False
descubrimiento	False
desempeñar	False
reconstruir	False
tacto	False
enormemente	False
veneno	True
reconciliación	False
vertiente	False
estrechamente	False
dispersión	True
electrón	True
lámina	False
insólito	False
protocolo	False
temblor	False
cinturón	False
adaptar	False
higiene	True
palinuro	False
someter	False
helms	False
triángulo	True
criado	True
invertido	False
réplica	False
aluminio	False
américo	False
bata	True
confuso	False
enteramente	False
unánime	False
levemente	False
legado	False
aviación	True
cruzado	False
compasión	False
cortesía	False
trapo	True
convencimiento	False
rallado	False
coma	False
recesión	True
compatriota	False
cuadra	False
violín	True
alcoholismo	False
camarero	True
textura	True
quedo	False
reclamo	False
silueta	False
ecológico	False
explotar	False
nacho	False
asumido	False
bastón	True
especialización	False
racionalidad	False
metálico	False
frontal	False
rata	False
depresivo	False
crueldad	True
retención	True
despertado	False
renacimiento	True
soberbia	True
valle	False
auxilio	True
convergencia	True
saliva	True
facción	False
proliferación	False
nómina	False
olla	True
secuestrado	True
liquidación	True
lienzo	False
idiota	False
hormona	True
manga	True
apreciación	True
largamente	False
semanario	False
flexible	False
desacuerdo	False
atreverse	False
serpiente	True
correlación	False
prosperidad	True
escape	True
fotográfico	False
discreto	False
ministerial	True
cereal	False
crucial	False
pascual	False
sendero	False
canadiense	False
nudo	False
emisor	False
erosión	True
obligatorio	False
encabezar	False
cineasta	False
lavar	False
cauce	False
flamenco	False
rebaja	False
polo	False
descontento	False
economista	True
tope	False
simpático	False
indirectamente	False
demora	False
despejado	True
cueva	False
oyente	True
encerrar	False
hidrógeno	True
quieto	False
velada	False
amargo	False
dinámico	False
encender	False
administrar	False
soltar	True
geometría	True
recuento	False
tropical	True
mostrador	False
progresista	True
gradual	False
aurora	True
cuñado	True
prostitución	True
liberalización	False
tumor	False
jacinto	False
custodia	True
brisa	True
protestar	False
cohesión	True
extremidad	False
mate	True
fósil	True
cerco	False
cargar	False
insulto	False
decepción	False
tibia	True
cesar	False
proseguir	False
mayoritario	False
liberar	False
encendido	True
rendir	False
precioso	True
nativo	False
discrepancia	False
viabilidad	False
socialmente	False
sugerencia	False
contratar	True
lineal	False
vísperas	False
explosivo	True
agradecimiento	False
ventanilla	False
movido	False
formidable	False
descendiente	False
renovar	True
helado	False
dionisio	False
toma	True
escogido	False
vayas	False
bando	False
vener	False
espuma	True
vocal	False
gigantesco	False
batería	True
contribuyente	True
abastecimiento	True
aguja	True
codo	True
afortunadamente	False
inserción	False
talante	False
torpe	False
precipitación	False
recibo	True
rodar	False
interpretado	False
autorizado	False
dioso	False
incómodo	True
lucrecia	False
mudo	False
fracasado	False
suavidad	True
fugaz	True
activamente	False
regir	False
vitoria	False
despido	True
prescindir	False
francamente	False
dominación	False
implicación	False
designar	True
mozo	True
amoro	False
rentable	False
resaltar	False
calibre	False
originalidad	True
históricamente	False
vestíbulo	True
cocer	False
lucidez	False
fina	False
ezequiel	False
pipa	False
ceja	True
guapo	False
rebeldía	True
protector	True
opositor	False
cubrar	False
interrogante	False
tirado	False
restar	True
reproducir	False
envergadura	False
agitación	False
amarguro	False
devolución	False
vértigo	True
murmurar	False
alzar	False
disminuido	False
certificar	False
lío	True
estallido	False
extra	False
enfermería	True
asomar	False
prolongación	True
liberado	True
excursión	False
membrana	True
concentrado	True
cal	False
capricho	True
aconsejable	False
ascensor	True
cátedra	False
dinamismo	True
honestidad	True
verificar	True
contemplación	True
falsedad	True
sereno	False
acumulado	True
conformación	False
cautela	False
descomposición	True
lomo	False
viceversa	False
chorro	False
callado	False
camioneta	False
concha	True
agresivo	False
inventar	False
vocero	False
genero	False
auxiliar	True
biología	True
abanico	False
electo	False
polémico	False
carcajada	False
nutrición	False
despedir	False
opresión	True
comportar	False
defendido	False
cantabria	True
sincero	True
inmediaciones	False
velo	True
difunto	False
reinado	True
milla	False
oficio	False
encierro	False
incumplimiento	True
linda	False
nutriente	True
eguren	False
mixto	False
paradigma	False
realizador	False
consorcio	False
saludable	True
puntualizar	False
refuerzo	False
diversión	False
fortalecimiento	False
mezclar	False
jaula	True
silencioso	False
contratado	False
arrastrar	True
tele	False
saludar	False
incipiente	False
franquista	False
cañón	False
dominado	False
patricio	False
pastor	True
sequía	True
difundir	True
contraloría	True
show	False
metabolismo	False
etiqueta	True
extraordinariamente	False
concebir	False
ambigüedad	True
campana	True
soberano	False
súbito	False
bulto	False
kid	False
promotor	True
brindar	False
atributo	False
fray	False
irreversible	True
arterial	True
petrolero	True
diverso	False
contracción	True
rigidez	True
itinerario	False
cónsul	False
sartén	True
alfombra	False
tribu	True
adjunto	False
banquero	True
licitación	False
desigualdad	True
aliviar	False
indudablemente	False
guante	True
adjudicación	True
larra	False
compadre	False
