word	group_known
año	True
país	True
ver	False
caso	True
vida	True
hombre	False
forma	True
pasar	False
decir	False
presidente	True
hacer	True
mujer	True
mundo	False
querer	False
llegar	False
español	True
dejar	False
nacional	False
partido	True
persona	True
grupo	True
público	False
quedar	False
ir	False
mano	True
punto	True
millón	False
problema	False
dar	False
social	False
política	True
político	False
obra	True
salir	True
ciudad	True
encontrar	True
volver	False
seguir	False
pensar	False
sistema	True
importante	False
tipo	True
mes	True
económico	False
agua	True
cambio	True
derecho	False
alto	True
situación	True
frente	False
hablar	False
noche	False
poner	False
tomar	False
empresa	True
historia	True
padre	True
venir	False
fuerza	True
proceso	True
centro	True
relación	True
único	True
vivir	False
parecer	False
esperar	False
servicio	True
producir	False
palabra	True
pueblo	True
hijo	False
mantener	True
pequeño	True
cuerpo	True
permitir	True
siglo	True
nombre	True
mirar	True
sociedad	False
llevar	False
presentar	True
llamar	False
acción	False
ojo	True
creer	False
puesto	False
humano	True
niño	True
número	True
él	False
gente	False
ministro	True
semana	False
realidad	True
nivel	False
tierra	False
libro	False
programa	False
equipo	True
joven	True
resultado	True
desarrollo	True
proyecto	True
guerra	True
recordar	True
saber	False
actividad	True
razón	True
necesario	False
familia	True
estudio	False
zona	True
idea	True
tema	True
muerte	True
entrar	True
madre	False
internacional	False
condición	True
paso	False
interés	True
comenzar	False
principio	False
cabeza	True
calle	False
mañana	False
señor	False
información	True
sector	True
voz	False
don	False
buscar	True
sentir	False
puerta	False
medida	False
militar	False
efecto	False
director	True
movimiento	True
preguntar	False
posibilidad	True
mercado	True
empezar	False
viejo	False
fondo	False
orden	True
pedir	True
luz	True
resultar	False
aparecer	False
tratar	False
policía	False
peseta	False
hora	True
real	True
principal	True
imagen	True
miembro	True
llamado	False
blanco	True
recibir	False
actual	True
papel	True
amigo	False
especial	True
falta	True
comisión	False
campo	True
necesidad	True
cosa	False
camino	True
organización	True
seguridad	True
minuto	False
negro	True
comunidad	False
figura	True
acabar	False
europeo	False
capital	False
banco	False
decisión	False
producto	True
mayoría	False
perder	True
espacio	True
interior	True
servir	False
futuro	True
fuente	True
función	False
personal	True
oficial	False
investigación	True
popular	True
juego	True
objetivo	True
duda	True
libertad	False
base	False
clase	False
abrir	False
contar	True
arte	True
medio	True
lograr	True
conocer	False
difícil	True
pie	True
ocasión	False
ocurrir	False
objeto	True
elección	True
central	True
ofrecer	False
menor	False
jefe	False
causa	True
población	True
cultura	True
presente	False
música	True
dio	False
producción	True
médico	True
recurso	False
autor	True
dinero	True
línea	True
dirección	False
aspecto	False
precio	False
fuerte	True
muerto	True
color	True
convertir	True
santo	False
vista	True
presencia	False
distinto	True
considerar	True
asunto	False
autoridad	True
resto	True
civil	False
elemento	False
cara	True
consecuencia	False
acto	False
visto	False
carácter	False
gustar	False
dólar	False
diario	True
posición	True
peso	True
dato	True
argentino	False
julio	False
francés	True
gracia	False
hecho	False
natural	True
economía	True
común	True
caer	False
conocido	True
edad	False
cambiar	True
época	False
superior	True
conjunto	True
libre	True
experiencia	True
rey	False
especie	False
región	True
seguro	True
alcanzar	True
mostrar	True
llegado	False
comunicación	True
carta	False
capacidad	False
cumplir	False
serie	True
reunión	False
técnica	True
antiguo	True
mundial	False
contrario	True
término	False
entender	False
obtener	True
control	True
cargo	True
socialista	False
enfermedad	True
cantidad	True
opinión	True
referir	False
defensa	True
profesional	False
suponer	False
prueba	True
respuesta	True
utilizar	False
ganar	True
aire	True
terminar	False
jugar	False
artículo	True
prensa	False
cuarto	True
justicia	True
poder	True
privado	True
local	True
abierto	False
físico	False
crisis	True
malo	True
cuadro	False
evitar	True
realizar	False
mesa	True
operación	False
compañía	False
ministerio	False
unidad	False
televisión	False
izquierda	True
escribir	False
norteamericano	False
exterior	True
cuestión	False
área	False
administración	True
continuar	False
juez	False
material	True
largo	False
paciente	False
institución	False
salud	True
escuela	True
cultural	False
paz	True
trabajador	True
película	True
decidir	False
establecer	False
morir	False
estructura	True
metro	True
necesitar	False
educación	True
energía	False
ayuda	True
actitud	False
esfuerzo	False
nación	False
silencio	True
muestra	False
texto	True
conocimiento	True
histórico	False
responder	False
constituir	False
atención	True
allá	False
importancia	False
apoyo	True
científico	True
explicar	True
encuentro	True
formar	True
modelo	True
origen	True
hermano	False
declaración	True
suelo	True
extranjero	False
calidad	True
capaz	False
lucha	True
práctica	False
título	False
secretario	False
determinado	False
ciencia	True
brazo	True
máximo	True
bajo	False
escrito	False
solución	False
cine	True
animal	True
campaña	True
iniciar	True
propuesta	True
cabo	False
sueño	True
río	True
fecha	False
contenido	False
naturaleza	False
grave	False
ejército	False
sol	True
mar	False
especialmente	False
reforma	False
informe	False
materia	True
motivo	False
personaje	True
régimen	False
duro	True
electoral	False
interno	True
entrada	True
marco	False
éxito	False
señal	False
correr	True
incluir	True
carrera	True
expresión	False
concepto	False
organismo	False
vuelta	False
pobre	True
radio	True
sangre	False
domingo	True
particular	True
vía	False
ambiente	True
dirigente	True
familiar	True
corte	False
parte	True
soler	False
reconocer	False
formación	False
fiscal	False
diputado	False
característica	False
crear	True
cámara	False
responsable	False
democrático	True
representar	True
dolor	True
factor	True
tribunal	False
boca	False
mínimo	True
doctor	True
tercero	False
afirmar	True
américa	False
período	True
documento	True
planta	True
grado	True
arma	True
precisamente	False
técnico	False
señalar	False
existencia	True
ciudadano	True
jugador	True
líder	True
industria	True
suficiente	True
tratamiento	True
teatro	True
directo	True
mirada	False
aumentar	False
asociación	False
lleno	False
dispuesto	False
construcción	True
etapa	True
crecimiento	False
dirigir	False
actuar	False
puerto	True
deseo	True
sala	True
noticia	True
perdido	False
riesgo	True
plazo	False
derecha	True
asegurar	False
representante	True
momento	False
amplio	True
sacar	True
industrial	True
propiedad	True
funcionario	True
vino	True
claro	True
fácil	False
rojo	True
levantar	False
hija	False
escuchar	False
profundo	False
observar	False
inversión	True
leer	False
desarrollar	False
señora	False
norte	True
candidato	True
salida	False
sufrir	False
frío	True
tiempo	True
pleno	False
ejecutivo	False
participación	True
visita	False
página	False
juicio	False
finalmente	False
marcha	True
comercial	True
fundamental	False
municipal	False
armado	False
alemán	True
mitad	False
voto	False
sur	True
significar	False
grande	False
periodista	True
participar	True
responsabilidad	True
curso	True
aumento	False
dicho	False
crítica	False
miedo	True
terreno	False
oportunidad	False
contacto	False
existir	False
tarea	True
simple	True
comercio	True
pagar	False
valor	True
mayo	True
maestro	False
financiero	False
acerca	False
anunciar	False
memoria	True
conflicto	True
análisis	True
venta	True
presión	True
democracia	True
vecino	False
periódico	True
corazón	False
compañero	True
pretender	False
mayor	False
inmediato	False
golpe	True
mexicano	False
diferenciar	False
cama	True
profesor	True
carne	False
ocupar	False
completo	True
isla	True
negocio	True
estudiar	False
oposición	False
pese	False
declarar	False
aceptar	False
secreto	False
teoría	True
suceder	False
sujeto	True
favor	False
extremo	True
hospital	True
enero	True
artista	True
destacar	False
conciencia	True
atrás	False
rostro	True
dificultad	True
fenómeno	False
circunstancia	False
demanda	False
victoria	True
pensamiento	True
novela	True
estilo	False
lengua	True
diciembre	False
fuego	False
ingreso	False
preciso	True
provocar	False
mejor	True
creación	True
altura	False
adecuado	True
ejercicio	False
lista	True
concreto	False
previsto	True
negociación	False
error	False
indicar	False
suerte	True
club	True
método	True
enorme	True
corto	False
capítulo	False
demostrar	False
guardia	True
revolución	True
norma	True
cielo	False
voluntad	False
corresponder	False
sitio	False
edificio	True
departamento	False
traer	False
seguido	True
coche	False
herido	False
cifra	False
criterio	False
plano	True
entidad	True
normal	True
gesto	True
distancia	True
asimismo	False
aplicación	True
tocar	False
serio	False
permanecer	False
primero	True
junio	True
agente	True
tratado	False
pena	False
próximo	False
octubre	False
fiesta	True
judicial	False
inglés	True
fútbol	True
conversación	True
flor	True
actuación	True
beneficio	True
escena	True
década	True
mensaje	True
intención	False
destino	False
red	False
pieza	False
hotel	True
extraño	True
piedra	True
exposición	False
mover	True
peligro	True
comprender	False
similar	True
discurso	True
absoluto	False
religioso	False
violencia	False
presupuesto	True
víctima	True
provincia	False
moral	False
tradicional	False
corriente	True
andar	False
exigir	False
intervención	True
pérdida	False
general	True
territorio	True
nota	True
individuo	False
jamás	False
gasto	False
impuesto	True
alimento	True
doble	True
gusto	False
pintura	True
reciente	True
límite	False
definitivo	False
vehículo	True
poseer	False
oscuro	True
competencia	False
resolver	True
consumo	True
alma	False
instrumento	True
siguiente	False
positivo	False
básico	False
rápido	True
procedimiento	True
escritor	True
reunir	False
estudiante	True
vivo	True
par	False
detalle	False
propósito	False
instituto	True
revista	True
empresario	False
disponer	False
subir	True
masa	True
dirigido	False
correspondiente	False
abogado	True
verde	True
lenguaje	False
numeroso	True
oficina	False
tendencia	False
gestión	False
oro	True
presentado	True
hoja	False
versión	False
abril	True
moderno	False
complejo	True
pared	True
producido	False
referencia	False
influencia	True
sostener	False
actor	True
imposible	True
realizado	False
labor	True
marzo	True
disposición	True
reacción	False
jornada	False
sentimiento	False
cubano	False
septiembre	True
anterior	True
intentar	True
kilómetro	False
italiano	True
puro	True
ataque	True
superficie	True
alcalde	False
piel	True
visión	True
sombra	False
temporada	False
cerrado	True
celebrar	False
pierna	False
representación	False
trabajo	True
conducta	False
niña	False
teléfono	True
vacío	True
trabajar	True
depender	False
frase	False
tradición	False
oír	False
ventana	True
chino	False
caballo	True
sensación	False
compromiso	False
comité	False
transporte	False
noviembre	True
conducir	False
proponer	True
palacio	False
crédito	False
enfermo	False
contrato	True
advertir	False
habitación	True
temperatura	True
viento	True
doña	False
manifestación	True
rico	True
esperanza	True
cadena	True
justo	True
utilizado	False
regional	True
fase	False
negativo	True
específico	False
canal	True
colegio	False
instante	True
matar	False
ritmo	True
comunista	False
tono	False
surgir	False
colectivo	False
barrio	True
soldado	True
ámbito	False
pago	True
nacer	False
debate	True
citado	False
ley	True
delito	False
jurídico	False
diálogo	False
comienzo	True
intelectual	False
dedo	False
ayuntamiento	False
negar	True
sindicato	True
selección	True
urbano	True
relacionado	False
espíritu	False
legal	True
lunes	False
empleado	True
verano	True
árbol	True
mecanismo	False
agosto	False
azul	True
alumno	False
cerrar	True
entrevista	False
poeta	True
lugar	False
droga	True
contener	False
triunfo	False
vender	False
impedir	True
raíz	False
realmente	False
afectado	False
afectar	False
sábado	False
activo	False
considerado	True
ventaja	False
instalación	True
catalán	True
estrategia	True
directamente	False
vestido	False
apoyar	False
viernes	False
comida	True
confianza	True
personalidad	True
iniciativa	False
marido	False
caber	False
caja	False
frecuencia	True
espalda	False
totalmente	False
establecido	False
descubrir	False
clásico	False
piso	False
final	True
marca	True
evidente	True
escenario	False
unir	True
esposa	False
entero	True
generación	True
volumen	True
acceso	False
previo	True
detener	False
dormir	False
protección	True
comer	False
echar	False
deber	False
detenido	False
vivienda	False
franco	False
dedicado	False
pertenecer	False
presidencia	False
febrero	True
firma	True
lógico	False
junto	False
pareja	False
carretera	True
museo	False
federal	True
evolución	True
vasco	False
superar	True
pan	True
pelo	False
crecer	False
deuda	False
toro	False
sentar	False
defender	False
tasa	False
reducir	True
constante	True
independiente	True
destinado	True
determinar	False
externo	True
avión	True
hermana	True
café	True
elevado	True
oferta	False
abajo	True
cercano	True
bajar	True
diferencia	True
tecnología	True
original	True
calor	False
mamá	True
perspectiva	True
casa	True
querido	False
sesión	True
clave	True
definir	True
sonido	True
abandonar	True
obligado	False
sexual	False
feliz	False
aplicar	False
aparato	False
consistir	False
ropa	False
posterior	True
oído	False
eléctrico	False
estrella	False
titular	False
habitual	True
rato	False
respeto	False
hallar	False
cárcel	False
famoso	False
parlamentario	False
literatura	False
comportamiento	True
edición	True
asamblea	False
musical	True
convertido	True
órgano	False
enemigo	False
inferior	True
amenaza	False
artístico	False
signo	True
cuidado	True
preparar	True
división	True
loco	False
bolsa	False
fin	True
colocar	True
muchacho	False
fotografía	True
audiencia	True
preocupación	True
opción	True
repetir	False
seco	False
actualidad	True
laboral	True
expresar	False
recoger	False
constitucional	False
acudir	False
requerir	True
leche	False
interesante	True
desear	False
individual	False
recibido	True
costumbre	True
añadir	False
regresar	True
parque	True
accidente	True
carga	True
informar	False
británico	False
lector	True
deportivo	False
decidido	False
categoría	True
banda	False
deporte	True
espectáculo	False
frecuente	True
explicación	True
dedicar	False
falso	True
importar	False
medicina	True
agencia	False
semejante	False
enfrentar	False
permanente	False
relativo	True
foto	True
simplemente	False
adquirir	False
aceite	False
situado	True
fig	False
género	True
inicial	False
cubierto	False
haber	False
margen	True
lluvia	True
posible	True
sorpresa	True
tensión	False
huelga	False
prácticamente	False
imponer	False
alianza	False
publicado	True
gobernador	True
manifestar	False
tomado	False
recién	False
fórmula	False
habitante	True
conclusión	True
ausencia	True
denuncia	True
concepción	False
daño	False
escaso	False
dimensión	False
gol	False
llevado	False
compra	True
grito	False
efectivo	False
concluir	False
frontera	True
madera	True
elegido	True
gritar	True
solicitar	True
velocidad	True
argumento	True
acontecimiento	True
contribuir	False
tamaño	False
pecho	False
jardín	False
tío	False
regla	True
estatal	False
temor	False
letra	True
construir	False
independencia	False
hombro	False
impresión	False
esencial	False
salón	True
célula	False
probablemente	False
revelar	True
mejorar	True
martes	False
obligación	False
supremo	False
enseñanza	False
formado	False
cliente	True
insistir	True
ruido	True
posteriormente	False
cocina	False
máquina	False
misión	False
interpretación	True
síntoma	False
igualmente	False
protagonista	True
acompañado	False
estación	False
montaña	False
reina	False
parecido	False
identidad	True
aparte	False
hacienda	False
encargado	False
experto	True
anual	True
significativo	False
enviar	True
auténtico	False
olvidar	False
contestar	False
partida	True
canción	True
acompañar	False
unido	False
revolucionario	False
disco	True
pacto	False
funcionamiento	True
pintor	True
comprobar	False
reserva	False
aparición	False
excepción	False
registro	True
sustancia	False
protesta	False
sección	True
ideal	True
existente	True
incremento	True
liga	False
costo	True
lectura	True
componente	True
católico	False
distribución	True
suma	True
aprender	False
avance	True
sede	False
plata	False
liberal	False
estadounidense	False
jueves	False
portavoz	False
crítico	True
concentración	True
publicar	True
bello	True
huevo	False
incluido	False
punta	False
situar	True
continuación	False
confirmar	False
dado	True
chico	False
gas	False
obrero	True
federación	True
bien	False
asistir	False
fe	False
romper	True
lanzar	True
índice	False
preparado	True
ser	False
interesar	False
filosofía	True
marino	False
colombiano	False
introducir	False
amar	False
luna	False
facultad	True
postura	True
asesinato	True
virtud	False
excelente	True
presentación	True
comprar	False
ayudar	False
discusión	True
significado	True
localidad	False
acaso	False
acuerdo	False
búsqueda	False
crimen	True
occidental	True
vaso	True
testigo	True
socio	True
cuello	True
espejo	False
resolución	True
meter	False
labio	True
guardar	False
indio	False
ciclo	True
logrado	True
cita	True
notable	False
matrimonio	False
cristiano	False
compuesto	True
código	False
generalmente	False
caída	True
barco	False
desarrollado	False
misterio	False
convenio	True
creado	False
faltar	False
porcentaje	True
controlar	True
intervenir	False
acercar	False
nacido	True
reducción	False
culpa	False
sentado	False
batalla	True
comentario	True
mental	True
miércoles	False
pregunta	True
espectador	False
colaboración	True
mente	True
sentencia	True
educativo	True
consideración	False
múltiple	False
coincidir	False
chileno	False
decreto	True
recuperar	False
pasión	True
dueño	True
obligar	False
establecimiento	False
únicamente	False
entrega	True
asumir	False
triste	True
vuelto	False
intenso	False
desconocido	False
hermoso	False
literario	False
funcionar	False
plan	True
juventud	False
caliente	True
campesino	False
pendiente	False
organizado	False
inicio	True
inmediatamente	False
círculo	False
paisaje	False
automóvil	False
rueda	True
femenino	False
publicación	True
firme	True
equilibrio	True
ruso	True
presidencial	False
aprovechar	False
sencillo	True
ocurrido	False
integración	True
perfectamente	False
útil	False
desaparecer	False
recuperación	True
ánimo	False
calificar	True
composición	False
perfecto	True
petición	True
hogar	False
sonrisa	True
chica	False
fruto	True
preso	False
mandar	False
claramente	False
vuelo	False
tabla	True
terrorista	True
horno	True
depresión	True
policial	False
cuenta	False
peligroso	False
patria	False
corrupción	True
belleza	False
prisión	False
especialista	True
cadáver	False
auto	True
autónomo	True
sindical	False
esquema	True
conservar	True
papá	False
rasgo	False
plato	False
segundo	True
admitir	False
relato	False
tráfico	False
transformación	True
ordenar	True
modificación	True
potencia	True
atentado	False
azúcar	True
reflexión	True
pista	False
agregar	True
interesado	False
realización	True
gobierno	True
muchacha	False
clínico	False
resistencia	False
coronel	False
reconocimiento	False
universal	True
playa	True
observación	True
investigador	True
despertar	False
moneda	True
concierto	False
alegría	False
religión	True
silla	True
ejemplar	False
poesía	False
salario	False
seguramente	False
caminar	False
generar	True
fijar	False
municipio	False
clima	True
mando	False
conseguir	False
publicidad	True
eficaz	False
nervioso	True
alcance	False
capitán	True
puente	True
brillante	False
latino	False
garantía	False
torre	False
sexo	False
ganado	False
cooperación	True
productor	True
radical	False
universitario	True
planeta	True
preferir	False
utilización	False
apertura	True
anuncio	False
solidaridad	True
sometido	False
mencionado	False
encontrado	True
consciente	True
americano	False
obtenido	True
tren	False
cultivo	True
atender	False
senador	False
dulce	False
conseguido	False
telefónico	True
acusación	False
emoción	True
liberación	False
capa	True
rama	True
acusado	False
lento	True
escala	False
disciplina	True
conde	False
renunciar	False
alcohol	True
cubrir	False
extraordinario	True
consulta	False
contexto	True
curioso	True
diplomático	False
juzgado	False
rival	False
exportación	True
exceso	True
raro	False
borde	True
avanzar	True
hambre	True
regular	True
retirar	False
elaboración	False
débil	True
costar	False
tranquilo	True
vicepresidente	False
tía	False
pausa	True
aventura	True
bastar	False
hueso	False
proceder	False
alternativo	False
columna	True
paro	False
intensidad	False
exigencia	False
madrugada	False
rápidamente	True
invitado	False
poema	True
símbolo	False
desnudo	False
entorno	False
registrar	False
incorporar	False
motor	True
tiro	False
proporción	True
amarillo	False
cristal	True
amistad	True
procedente	False
turismo	True
impulso	True
cantar	False
aclarar	False
meta	True
ajeno	False
editorial	False
viajar	True
dominio	True
presunto	True
ensayo	False
nuevamente	False
reducido	False
núcleo	False
coger	False
completamente	False
madrileño	False
propietario	True
recientemente	False
roca	True
dependencia	True
elegir	False
despacho	False
salvar	False
variedad	False
adoptar	False
tienda	True
conservador	False
organizar	True
dibujo	False
mezcla	True
periodo	False
geografía	False
entregar	False
moda	False
festival	False
colonia	True
taza	False
coste	False
príncipe	False
seno	False
apartado	False
rechazar	False
mejora	True
terrible	False
usuario	True
traje	False
ilusión	True
productivo	False
nuclear	False
secretaría	False
ácido	False
tejido	False
gubernamental	False
convenir	False
gana	False
honor	False
placer	False
continuo	True
infantil	True
griego	True
escalera	True
analizar	True
diente	False
consejero	False
variable	True
terminado	True
amiga	False
fiel	False
evidencia	True
instrucción	False
inmenso	False
favorable	False
totalidad	False
aprobado	True
anciano	False
agricultura	True
contemporáneo	False
lesión	True
emisión	False
inteligencia	True
baño	False
bandera	True
vital	True
apuntar	False
olor	False
cerebro	True
preparación	True
basado	False
abuelo	False
risa	False
botella	False
bomba	True
obispo	True
global	True
informativo	False
absolutamente	False
contemplar	False
instancia	False
polvo	False
humor	True
enfrentamiento	False
conformar	False
naturalmente	False
fracaso	False
ceremonia	False
soviético	False
creciente	True
efectuar	False
violento	False
caracterizar	False
fila	True
delegado	False
regreso	True
proteína	True
déficit	False
quitar	False
suave	True
valer	False
solar	True
reconocido	False
diseño	True
suceso	False
galería	False
cumbre	False
correcto	True
testimonio	False
potencial	True
provincial	True
merecer	False
planteamiento	False
fundamentalmente	False
gloria	False
compartir	False
universo	True
escanda	False
alteración	True
secundario	True
definitivamente	False
teórico	False
extender	True
concesión	False
prima	False
recorrido	False
bloque	False
ejercer	False
llorar	False
oreja	False
comunicado	False
derrota	True
colección	False
amante	False
cierre	False
lejano	False
combate	True
definición	True
escolar	True
retrato	True
ambiental	False
formal	True
dosis	True
exclusivamente	False
embajador	True
muro	False
idioma	True
rodilla	False
inflación	True
residencia	False
soledad	False
eficacia	False
respectivamente	False
garantizar	False
rural	True
impacto	True
peruano	True
tender	False
fábrica	False
facilidad	True
ocupado	True
denominado	True
exactamente	False
autonomía	True
comentar	False
nacionalista	False
agrícola	False
especializado	False
eje	False
celebrado	False
asistencia	False
líquido	True
probable	True
duración	True
defensor	True
petróleo	True
invierno	True
laboratorio	True
tecnológico	True
encuesta	True
venezolano	False
nacimiento	True
pedido	False
preocupar	False
nariz	False
kilo	False
inútil	False
extensión	True
bar	False
tesis	True
afirmación	True
desaparecido	False
pantalla	True
paseo	False
administrativo	False
facilitar	True
implicar	False
ideológico	False
atractivo	True
visitar	False
cálculo	False
ejecución	True
episodio	True
incidente	True
oy	False
químico	False
plantear	False
tirar	True
imperio	False
convencido	False
ruta	True
imaginación	True
estabilidad	True
castellano	False
adolescente	True
tarjeta	False
orgullo	True
músico	False
reflejar	False
sonreír	False
reflejo	False
fruta	False
emisora	False
limpio	True
visitante	True
condenado	False
abundante	True
distrito	False
claridad	True
estímulo	False
redacción	False
solicitud	False
canto	False
estético	False
empresarial	False
novedad	True
cura	False
beber	True
hierro	True
riqueza	True
grasa	True
sonar	True
senado	False
promedio	True
temporal	True
cometido	False
patio	False
otan	False
tropa	True
consumidor	False
nube	False
mencionar	False
integrado	True
académico	False
hipótesis	True
sólido	True
cruzar	True
árabe	True
músculo	False
orquesta	True
monte	False
diagnóstico	True
expectativa	True
rechazo	False
colega	False
pesado	True
ilegal	False
limitar	True
restaurante	True
respectivo	False
supuesto	False
romano	True
excesivo	False
institucional	True
sacerdote	True
retirado	False
distinguir	True
progreso	True
remedio	False
vegetal	False
piloto	False
fortuna	False
aeropuerto	True
abuela	False
marcado	True
camión	False
rendimiento	False
templo	False
adulto	True
republicano	False
subrayar	True
sanción	False
difusión	True
cucharada	False
mantenimiento	False
latinoamericano	False
estrecho	False
pobreza	True
bolsillo	False
prestigio	False
patrón	False
transición	True
uniforme	False
cumplimiento	False
cantante	True
gris	True
pensión	False
avenida	False
lentamente	False
satisfacción	True
medicamento	True
mentira	False
paquete	True
viaje	False
dictadura	False
comunitario	False
salto	True
vigente	False
indígena	True
cáncer	True
hilo	False
descenso	False
entusiasmo	True
ideología	True
recuerdo	False
iniciado	False
variación	False
explotación	True
manejo	True
judío	True
imaginar	False
asiento	True
aprobación	False
aprobar	False
acusar	False
luchar	False
representado	False
conveniente	False
mediado	False
candidatura	True
rumor	False
acordar	False
torneo	True
parcial	True
universidad	True
enseñar	False
polémica	False
particularmente	False
atmósfera	True
pasillo	False
descubierto	False
conductor	True
estadio	True
infección	False
efectivamente	False
circulación	True
separar	True
sospecha	True
aficionado	False
rincón	False
campeón	False
manifiesto	False
feria	True
exponer	True
trato	False
trastorno	False
taller	True
hábito	False
sanitario	False
ingrediente	True
humanidad	False
fácilmente	False
conceder	False
poderoso	True
infancia	True
sensible	True
obstáculo	False
rayo	False
pasado	True
rumbo	False
verso	False
ejemplo	True
decisivo	False
legislación	False
plástico	False
magistrado	False
limitación	True
campeonato	False
operar	False
tela	True
demostrado	False
justificar	False
pájaro	False
promesa	True
sierra	False
alimentación	True
esquina	False
expansión	True
exclusivo	True
vacaciones	True
alcanzado	False
clasificación	True
reloj	False
banca	False
concejal	False
ingeniero	True
corredor	False
arena	True
anteriormente	False
comandante	False
cotidiano	False
contradicción	True
homenaje	False
gravedad	True
limitado	True
importación	False
espectacular	False
mero	False
baja	False
litro	True
sensibilidad	False
lágrima	False
estancia	False
héroe	False
profundidad	False
emitir	False
anunciado	False
autonómico	False
disminuir	False
expediente	False
tabaco	True
renta	False
concurso	True
nave	False
angustia	False
directivo	False
restante	False
terrorismo	True
cigarrillo	False
trasladar	True
sacrificio	False
evaluación	True
felicidad	False
modalidad	False
oscuridad	False
aportación	False
culpable	False
describir	False
virus	True
caballero	False
incapaz	True
previamente	False
combinación	True
partidario	False
destacado	False
permiso	True
vivido	False
cena	False
raza	False
ampliación	True
noble	False
sufrido	False
fino	False
orilla	False
teniente	False
viajero	True
vencer	True
equivalente	True
corona	True
incendio	True
llave	False
dignidad	True
depósito	True
crónica	False
docente	True
fantasma	True
defecto	False
biblioteca	True
militante	False
humo	True
firmar	False
espacial	False
ancho	False
cartel	False
cuerda	False
cuota	False
fresco	False
precisar	False
ópera	False
continuidad	False
cualidad	False
pantalón	False
cuadrado	True
tonelada	True
igual	False
dama	False
gen	False
comprensión	True
metal	True
logro	False
convocatoria	False
profesión	True
regalo	True
plante	False
entrenamiento	True
requisito	False
gato	True
bebida	False
coalición	True
descanso	False
promoción	False
aprendizaje	True
identificar	False
continente	True
tarifa	True
síntesis	False
ligero	True
evento	True
arquitectura	True
visible	True
aislado	False
integrante	False
mineral	True
orientación	False
destrucción	True
bancario	False
primavera	True
confusión	True
huella	False
proporcionar	False
financiación	True
panorama	True
guerrillero	False
permitido	True
relativamente	False
disponible	False
celebración	True
ordenador	True
disparo	False
anoche	False
cabello	True
disminución	True
vinculado	True
separado	True
oculto	True
inquietud	False
afuerar	False
milagro	False
curiosidad	True
mediodía	False
arco	False
circuito	True
placa	False
creador	True
absurdo	False
ernesto	False
embajada	False
patrimonio	False
proteger	False
mérito	False
juvenil	True
fantasía	False
construido	False
carecer	False
onda	True
palma	False
adelantar	False
sueldo	True
centenar	False
compositor	True
desaparición	False
colaborador	True
gira	False
aéreo	False
sumar	False
precedente	False
maniobra	True
semilla	False
aceptado	False
investigar	False
cinta	True
temer	False
criminal	False
genético	False
pensado	False
programación	False
prever	False
estable	True
durar	False
definido	False
sorprender	False
integrar	True
inocente	False
dios	False
aliado	True
estructural	False
conexión	False
cobrar	False
mandato	True
mapa	True
creencia	True
oriental	False
verdadero	True
beso	True
suficientemente	False
consenso	True
necesariamente	False
eterno	False
fama	True
casado	True
emperador	False
mecánico	False
intérprete	False
curva	True
harina	False
aportar	False
igualdad	False
avanzado	False
varón	False
pecado	False
sabor	False
oeste	False
posesión	True
vídeo	True
pata	False
delegación	False
mito	False
bolívar	False
fundamento	False
israelí	False
lateral	True
copia	False
carro	False
setenta	True
agresión	False
leve	False
legislativo	False
reglamento	False
suizo	True
primario	True
vigor	True
lujo	False
corresponsal	False
asesino	True
percepción	True
león	False
fijo	False
ala	True
perro	True
rigor	False
recorrer	False
escultura	False
estadística	True
plaza	True
prestar	False
digno	False
ubicado	True
vigilancia	True
excepcional	False
sucedido	False
dominante	False
archivo	True
esencia	False
variado	False
rebelde	True
exacto	True
geográfico	True
bonito	True
eliminar	True
brasileño	False
guerrilla	False
interpretar	True
trámite	False
medir	False
adicional	False
marcar	False
tramo	False
horario	True
trozo	True
dormido	True
cortar	False
denunciar	False
caído	False
visual	True
dieta	False
firmado	False
comerciante	False
asesor	True
narcotráfico	False
asistente	False
xx	False
dinámica	True
arquitecto	True
apreciar	True
electrónico	True
siquiera	False
préstamo	True
turno	False
manejar	False
constituido	False
calma	False
intercambio	True
conservación	True
combustible	True
enviado	False
odio	True
olvidado	False
pescado	False
examen	True
gobernante	False
abuso	False
registrado	True
jugado	False
zapato	False
multitud	True
precisión	False
monetario	False
rodear	False
imprescindible	False
revisión	False
gota	False
artificial	True
baile	False
secuencia	True
aporte	False
derivado	True
entrenador	True
esfera	False
ángulo	False
verdaderamente	False
queja	True
complicado	False
estimar	True
ave	True
previsión	False
profundamente	False
danza	True
ética	False
ruptura	True
identificación	True
castigo	True
percibir	True
mortal	False
tel	False
sucesivo	False
separación	True
herramienta	True
perfil	False
recto	False
apariencia	False
respaldo	False
masculino	True
península	False
violación	True
pacífico	False
horizonte	False
bienestar	True
ciego	False
vitamina	True
párrafo	False
aparentemente	False
condena	False
lección	False
detención	True
camisa	False
tragedia	False
aspiración	False
japonés	False
transformar	True
alternativa	True
comparación	True
tve	False
rodeado	False
sustituir	True
masivo	False
favorecer	False
desgracia	False
privilegio	False
participante	True
voluntario	True
ciertamente	False
sano	False
contaminación	False
íntimo	True
terrestre	True
elevar	True
ligeramente	False
humedad	True
inconveniente	False
queso	True
grano	False
autobús	False
medalla	True
ola	False
tristeza	True
lado	False
delicado	True
vergüenza	False
opuesto	True
fibra	True
infinito	True
socialismo	True
satélite	True
pluma	True
trayectoria	True
secuestro	False
diablo	False
inevitable	True
cebolla	False
suspensión	True
alza	False
descripción	False
finalidad	False
tomate	False
actriz	True
expuesto	False
cola	False
posiblemente	False
amparo	False
provocado	False
prioridad	True
maíz	False
mancha	False
infraestructura	False
urgencia	True
tranquilidad	True
progresivo	False
xviii	False
torero	False
causar	False
experimento	False
sexto	False
nieve	True
funcional	True
atravesar	False
terror	False
ap	False
incorporación	False
antecedente	False
grueso	True
negociar	True
bosque	True
típico	False
vocación	True
observador	True
piano	False
normalmente	False
instalado	False
granada	False
intento	True
receptor	True
licencia	False
pasajero	True
balance	True
ganancia	False
plenamente	False
domicilio	True
aceptación	False
dramático	False
km	False
adiós	False
fotógrafo	True
oriente	False
votación	True
titulado	False
divisa	False
elemental	True
gordo	False
agudo	False
emergencia	True
subida	True
premio	True
quinto	False
componer	False
singular	False
pelota	True
parar	True
preferencia	False
convivencia	False
mina	False
guía	True
ansiedad	True
barrera	False
inteligente	True
ruina	True
novio	True
acceder	False
olvido	True
transferencia	True
talento	True
evidentemente	False
sucio	True
poético	False
vanguardia	False
magnífico	False
cm	False
casco	True
invitar	False
considerable	False
cero	True
dominar	True
desierto	True
exilio	True
pretensión	False
psicológico	False
propuesto	False
espiritual	False
aplicado	False
adaptación	True
botón	True
contraste	False
adentro	False
vela	True
desempleo	True
otorgar	False
perteneciente	False
prestación	False
izquierdo	True
salsa	True
fragmento	True
represión	False
tesoro	False
et	False
pedazo	False
locura	False
transmitir	False
recomendación	False
modificar	False
comisario	False
buque	True
novia	False
caza	True
proyección	True
combatir	False
doctrina	True
ingresar	False
abandono	False
urss	False
filósofo	True
explosión	True
renovación	False
llenar	True
muscular	True
química	True
transmisión	True
variar	False
corporación	False
billete	False
estricto	True
usado	False
determinación	False
convencional	True
pez	True
rapidez	False
sombrero	True
estómago	False
parado	True
paciencia	True
ronda	False
escapar	False
debilidad	True
miseria	False
indispensable	True
sugerir	True
otoño	False
montar	False
ocupación	False
magnitud	False
generalizado	False
corrida	True
biológico	False
acá	False
minoría	True
fusión	True
recogido	False
limpieza	True
prometer	False
herencia	False
pilar	False
paralelo	True
misa	False
cariño	True
deterioro	False
utilidad	False
culto	False
calcular	False
soberanía	False
abandonado	False
aniversario	False
turista	False
tránsito	False
incidencia	False
vigencia	False
gráfico	True
aparente	True
saltar	False
afán	False
documentación	True
prisa	False
personalmente	False
jurado	False
legislador	False
sagrado	True
recurrir	False
conquista	True
escritura	True
comando	True
costado	False
regulación	False
oficialmente	False
relevante	False
historiador	False
convicción	False
ucd	False
mercancía	True
finanzas	False
introducción	True
turístico	True
hallazgo	False
reclamar	False
esposo	False
discutir	False
declarado	False
retorno	False
pistola	False
gerente	True
cómodo	False
planificación	True
brusela	False
constantemente	False
censura	True
art	False
manzana	True
resumen	True
mágico	False
nombrado	True
maravillo	False
energético	True
movilización	False
nicaragüense	False
enfoque	False
corporal	True
reparto	False
sumamente	False
agrupación	True
síndrome	False
diversidad	True
coordinación	False
balón	False
relieve	False
urgente	False
pasaje	False
gramo	True
mueble	False
variante	False
promover	True
salvaje	False
burguesía	False
viuda	False
móvil	False
centímetro	False
vínculo	False
rubio	True
fiebre	True
acostumbrado	False
longitud	False
moderado	False
circular	False
cartera	True
ajuste	False
vientre	False
andaluz	True
soportar	False
extenso	False
fuga	True
mensual	True
metido	False
convocado	True
adquisición	False
vidrio	True
monumento	True
sorprendente	False
respiración	True
resistir	False
adn	False
elaborado	False
ajo	False
basar	False
provenir	False
integral	False
solitario	True
pronunciar	False
fallo	False
recinto	False
directiva	False
agradable	False
nombramiento	False
húmedo	False
indígeno	False
fabricación	True
señorita	False
india	False
comicio	False
xvii	False
autorización	True
traslado	True
boda	False
caldo	False
embarazo	False
molécula	False
casar	True
monarquía	True
molesto	False
hierba	False
habilidad	False
ahorro	True
divino	False
cintura	True
cinematográfico	False
reservado	False
basura	True
alicia	False
miel	False
asociado	False
cerveza	False
mediano	False
ampliar	False
públicamente	False
esclavo	False
infierno	False
foco	False
tremendo	False
sillón	False
eliminación	True
convocar	False
té	True
civilización	False
válido	False
valoración	True
certeza	True
demócrata	False
justamente	False
récord	False
doméstico	False
limón	False
refugio	True
libra	False
constar	False
deficiencia	False
oxígeno	False
complejidad	False
sustitución	True
prolongado	False
reivindicación	False
azar	False
nervio	False
confesar	False
prisionero	False
demonio	False
recepción	True
figurar	False
propaganda	True
calendario	False
aliento	False
significación	False
inspector	False
bala	False
usar	False
ascenso	False
manera	True
guión	False
retraso	True
leyenda	True
dimisión	False
mejilla	False
eco	True
revés	False
fundado	False
americana	False
admiración	True
comunicar	False
publicitario	False
instalar	False
estrictamente	False
plantilla	True
mariano	False
disfrutar	False
perfección	False
cancha	False
vendedor	True
mierda	False
romántico	True
encargar	False
crema	False
enterar	False
repercusión	False
denominar	True
decena	True
toque	False
carbón	True
rito	False
cobertura	False
padecer	False
favorito	False
alegre	False
soporte	False
gozar	True
montaje	True
ofensiva	False
espada	True
racional	False
invasión	False
puta	False
sucesión	False
acumulación	True
afición	False
entendido	False
trimestre	True
receta	False
presidido	False
consejo	False
rango	True
increíble	False
partir	True
disparar	False
inesperado	False
africano	False
cementerio	False
creativo	True
hielo	True
prevención	True
transcurso	False
frecuentemente	True
rock	False
confiar	False
aviso	True
asalto	False
supervivencia	False
perdón	False
atento	False
selva	True
satisfacer	False
distinción	True
falla	False
canciller	False
dispositivo	True
reto	False
refugiado	True
fraude	False
orgánico	True
seleccionado	False
fiscalía	False
capitalismo	True
ligado	False
sorprendido	False
cansancio	False
inicialmente	False
normativa	False
discípulo	False
rabia	False
reproducción	True
célebre	False
roto	False
seguimiento	True
intimidad	False
doloroso	False
cuenca	False
drama	False
consumir	False
criticar	False
colonial	True
básicamente	False
filme	True
adquirido	False
dorado	True
densidad	True
cuartel	False
cuento	True
prenda	False
adversario	False
barro	False
asesinado	False
llama	False
trágico	False
quinta	False
entendimiento	True
afrontar	False
barra	False
tumba	False
procesado	False
correo	True
hectárea	False
pasta	True
simultáneamente	False
probar	False
almuerzo	True
bahía	False
vano	False
primitivo	False
horror	False
seguidor	True
permanencia	False
pelea	False
prd	False
dormitorio	False
redondo	False
habitualmente	False
incertidumbre	True
listo	False
sonoro	True
privatización	True
elegante	True
and	False
comedor	False
peculiar	False
simbólico	False
teatral	False
tronco	True
empeño	False
repetido	False
influir	True
tercio	False
irregularidad	False
alejar	False
kg	False
vapor	True
razonable	False
propiamente	False
quibir	False
ganador	True
incapacidad	True
invitación	False
choque	True
garganta	False
productividad	False
robo	True
elaborar	False
asombro	False
respetar	False
bailar	False
bosnia	True
tarde	False
estratégico	False
almacén	True
manteca	False
censo	True
aislamiento	False
manolo	False
juzgar	False
nocturno	True
optar	True
jugo	True
enmienda	False
amanecer	False
huir	False
notar	False
genio	False
satisfecho	False
atlántico	False
tentación	False
entregado	True
secretaria	True
costa	False
severo	False
indicación	True
inés	False
provisional	False
empate	True
alarma	False
cuchillo	False
oral	True
trama	False
referente	False
giro	False
presa	False
parto	False
supuestamente	False
noción	False
directora	False
futbolista	False
cuero	True
ciudadanía	True
cocción	True
modo	True
sabiduría	False
preocupado	False
maldito	False
problemática	False
acento	False
indiferencia	False
helicóptero	False
desastre	True
fundar	False
reuter	False
citar	False
sudor	True
idéntico	False
ficción	True
ocultar	True
comedia	True
cortina	False
desesperado	False
manifestado	False
fachada	True
monto	False
inspiración	False
ternura	False
cansado	False
estallar	False
reír	False
planteado	False
desesperación	True
accionista	True
montón	False
tocado	False
nacionalidad	False
sufrimiento	False
votar	True
cerro	False
broma	False
afecto	False
rol	False
alba	False
suicidio	True
vertical	True
mandatario	False
psicología	True
correspondencia	False
pesca	True
marchar	False
electricidad	False
bebé	False
coro	True
postre	True
filosófico	False
asilo	True
alcaldía	False
colocado	False
contento	False
hueco	True
flujo	False
bordo	False
obtención	False
peor	False
endor	False
solucionar	True
delincuente	True
capitalista	True
mutuo	False
informado	False
film	False
caos	True
desafío	False
territorial	True
tormenta	True
diana	False
finca	True
traducción	True
rosario	False
finalizar	True
fuertemente	False
contribución	True
ajenar	False
partícula	True
madurez	True
inmigrante	False
incrementar	True
confederación	False
inspección	True
celular	False
gobernar	False
cocaína	False
terapia	False
taxi	True
uso	True
ignorar	True
acero	False
importe	False
altamente	False
impresionante	False
moder	False
mediterráneo	False
agenda	True
picado	True
balcón	False
difícilmente	False
lecho	False
clarín	False
plataforma	False
sandinista	False
vegetación	False
fortaleza	False
ignorancia	False
cable	True
prado	False
persecución	False
saco	True
captura	False
abundancia	True
inauguración	False
implantación	True
optimismo	True
completar	False
malestar	True
ridículo	False
venganza	False
ampliamente	False
deriva	False
emocional	False
docena	False
centroamérica	False
arrancar	False
desprecio	False
convencer	False
énfasis	False
cobre	True
concretamente	False
mal	True
financiamiento	False
copa	False
diámetro	False
crudo	False
nostalgia	True
parcialmente	False
ministra	False
grabar	False
indicio	False
alrededor	False
rescate	True
referéndum	True
sobrevivir	False
competir	False
lago	True
casualidad	True
contratación	True
alivio	True
alerta	False
oportuno	False
residir	False
residuo	True
trascendencia	False
mortalidad	False
probabilidad	True
fidelidad	True
ausente	True
flota	True
simpatía	False
algodón	False
eficiencia	False
obvio	False
estreno	False
liderazgo	True
lanzamiento	False
operativo	False
primo	False
apellido	False
modernización	True
ironía	False
cruel	False
ofrecido	False
coordinador	True
bloqueo	True
aborto	True
puramente	False
nacionalismo	False
eventual	False
reagan	False
amable	False
billón	False
perjuicio	False
brillo	True
pañuelo	False
excesivamente	False
conducción	False
excelencia	True
expulsión	True
últimamente	False
cerebral	False
desorden	True
retiro	False
expresado	False
exclamar	False
carencia	False
hígado	False
acercamiento	True
cc	False
prohibición	True
normalidad	False
bronce	False
carbono	False
transparente	True
presidir	False
magia	False
disputa	True
destruir	False
cúpula	False
consolidación	False
inconsciente	False
respectar	False
podero	False
sencillamente	False
denominación	False
verbal	True
muchísimo	False
inmóvil	False
riego	False
conferencia	True
trago	False
credibilidad	False
seda	True
pretexto	False
firmeza	False
inocencia	False
escasez	False
ritual	True
indicado	False
coincidencia	True
rehén	False
tubo	False
colón	False
vaticano	False
continuamente	False
convento	False
cerdo	False
esencialmente	False
atribuir	True
llanto	False
desconfianza	True
desayuno	True
libremente	False
fijado	False
colaborar	False
seriamente	False
leir	False
aparecido	False
licenciado	True
antena	True
maestra	False
iglesia	False
tolerancia	True
competición	True
evaluar	True
validez	False
rentabilidad	False
marcador	True
abordar	False
atracción	True
prohibido	True
configuración	True
órbita	True
gama	False
creatividad	True
jacque	False
fujimori	False
cosecha	True
considerablemente	False
pagado	True
chocolate	True
despedida	False
superado	True
detectar	False
realismo	False
descansar	False
levantado	False
fumar	True
adhesión	True
ubicación	True
inseguridad	False
mm	False
cardenal	False
salarial	False
inclusive	False
aproximación	False
penumbra	True
sumario	False
trigo	False
experimentado	True
causado	False
transparencia	True
reposo	False
cenar	False
majestad	False
reconstrucción	False
formato	True
insuficiente	True
práctico	False
celda	True
residente	False
políticamente	False
pollo	False
fundador	False
imposibilidad	True
enferma	False
repertorio	False
repetición	True
revisar	False
gala	False
rector	True
diariamente	False
terraza	False
escritorio	True
esperado	True
jerusalén	True
enamorado	False
capilla	False
cerámica	True
prevenir	False
pico	True
pesadilla	False
suavemente	False
duelo	False
pánico	False
delantero	False
retórica	False
invisible	True
cirugía	True
indudable	False
designación	False
jerarquía	True
pusar	False
trampa	False
recomendar	False
protagonismo	False
antigüedad	False
justificación	True
fallecido	False
reiterar	True
específicamente	False
dureza	False
rebelión	False
corregir	True
aldea	True
conveniencia	False
expedición	True
breve	False
gasolina	False
crecido	False
pimienta	True
dictador	False
perejil	False
presidenta	False
realista	False
ceder	False
vinculación	False
serenidad	False
analista	True
reforzar	False
adopción	False
extradición	False
rehabilitación	True
aplauso	False
modernidad	False
empleo	True
áfrico	False
invertir	False
maquinaria	False
discriminación	True
semestre	True
legalidad	False
ambición	True
comunismo	False
fatal	False
marqués	False
frenar	True
tenis	True
gafas	False
insecto	False
lamentable	False
sargento	False
instinto	True
falda	False
envidia	True
inscripción	True
restricción	False
demostración	True
volar	True
mención	True
gigante	True
uña	False
espectro	False
averiguar	False
opinar	False
pulso	False
adolescencia	True
complicación	False
balanza	True
gallego	False
experimental	False
caña	False
constancia	False
manipulación	True
coherente	False
seriedad	True
portero	False
merced	False
patente	False
óptico	False
característico	False
radicar	False
jurisdicción	False
horizontal	True
asociar	False
financiar	False
captar	False
suelto	False
obsesión	True
palestino	False
confrontación	True
sucesor	False
horrible	True
agujero	False
reportaje	False
divorcio	False
menú	True
cuidadosamente	False
pescador	True
grandeza	False
emprender	True
tapa	True
árbitro	True
tregua	False
compañera	False
popularidad	True
surgido	False
urna	False
auge	False
tradicionalmente	False
barba	False
sofá	False
fresca	False
celo	False
biografía	True
matiz	False
independientemente	False
desprender	False
comprometido	True
inminente	False
princesa	False
apuesta	False
rosa	True
humilde	False
pce	False
salvación	False
eficiente	False
irregular	True
abiertamente	False
complicidad	False
amor	True
radiación	True
emplear	False
innumerable	False
insistencia	False
tour	False
furia	False
pauta	False
valorar	True
encargo	False
elector	False
cese	False
sed	False
abrigo	True
porvenir	False
salina	False
trayecto	False
lanzado	False
participado	True
armar	False
descrito	False
ira	False
corteza	False
parámetro	True
comprendido	True
preferido	True
prudencia	True
equivaler	False
liberalismo	False
impulsar	False
verdura	False
unanimidad	False
mantequilla	False
sello	False
caro	False
injusticia	False
saldo	True
ríe	False
calcio	False
conocí	False
arzobispo	False
interacción	False
proveniente	False
cargado	True
restauración	True
túnel	False
implicado	False
deseado	True
papas	False
pariente	False
comercialización	True
rutina	False
integridad	False
correctamente	False
timbre	False
monopolio	True
pc	True
competitividad	False
torno	False
alusión	False
aprovechamiento	False
coherencia	True
respirar	False
designado	False
atacar	False
mentalidad	False
impotencia	False
sostenido	False
plenitud	False
anterioridad	False
escaño	False
conjuntamente	False
transcurrir	False
proposición	False
consultar	False
rtve	True
especialidad	False
fallecer	False
esplendor	False
joya	True
narración	False
manual	True
juro	False
enlace	True
marxista	False
vinir	False
pta	False
documental	False
dotado	False
altar	False
porción	True
practicar	False
bono	False
exactitud	False
apartamento	True
progresivamente	False
envío	True
catedrático	False
sobra	False
narrativa	False
doler	False
amplitud	False
abarcar	False
bola	False
procedencia	False
ordenado	True
extinción	True
veras	False
adecuadamente	False
sentimental	True
buscado	False
frustración	False
trazado	False
talla	False
ingenio	False
tim	False
atardecer	False
ejecutar	False
colocación	False
duque	False
advertencia	False
engaño	True
dependiente	True
exploración	True
hondo	False
comir	False
optimista	True
interminable	False
dedicación	True
saludo	True
agricultor	True
excusa	False
bota	False
lana	True
pozo	True
plomo	False
inversor	False
comarca	False
debido	False
cuidar	False
lástimo	False
víspera	False
legitimidad	True
elegancia	False
cometer	False
dictamen	False
proximidad	True
lazo	False
quiebra	False
brutal	True
consiguiente	False
acierto	False
legislatura	False
tortura	True
administrador	True
saint	False
moción	False
culo	False
agrario	False
conformidad	True
abrazo	True
umbral	False
borracho	False
traición	False
cucharadita	False
exhibición	False
consistente	False
franquismo	False
efectividad	False
notablemente	False
lingüístico	True
nuca	False
parada	False
confirmado	True
reestructuración	True
conversión	True
niebla	False
whisky	True
terminal	True
obviamente	False
superioridad	False
supresión	True
inestabilidad	True
revelación	False
metáfora	False
decoración	True
negado	False
natal	False
identificado	False
holandés	True
prudente	True
recuperado	False
aroma	True
capacitación	False
musulmán	True
sabio	False
fármaco	False
organizador	True
absorción	True
decadencia	False
superficial	True
manifestante	False
cemento	True
lavado	True
solemne	False
intermedio	True
querella	False
pronóstico	False
lentitud	False
encanto	False
sutil	False
debidamente	False
inclusión	True
oración	False
equivocado	False
serbio	True
medellín	False
económicamente	False
portugués	False
catástrofe	True
entierro	False
cocinar	True
monstruo	False
fauna	False
pureza	False
elevación	True
aceptable	False
fatiga	True
indicador	True
sábana	False
lema	False
medieval	False
digital	True
hagar	False
flexibilidad	False
tenor	False
apetito	False
acogida	False
chaqueta	False
comprado	False
pa	False
colesterol	False
certamen	False
reunido	False
frágil	False
urbanización	True
factura	True
harto	False
amnistía	False
confesión	True
despliegue	False
cabecera	False
delirio	False
determinante	False
anécdota	False
volante	False
bacteria	False
divertido	True
cumpleaños	False
insomnio	False
táctica	False
subido	True
nobleza	False
penetración	False
subasta	True
suministro	False
lógicamente	False
melancolía	True
lapso	False
ferrocarril	True
acordado	False
huida	False
piedad	False
subsecretario	False
localización	False
automáticamente	False
clausura	False
escoger	False
heroína	True
campamento	False
leña	False
recaudación	False
mérida	False
vinagre	False
acta	True
mármol	False
corrección	True
cartón	False
creído	False
portada	False
potente	True
iluminación	True
limpiar	False
medianoche	False
efectuado	False
intuición	True
sexualidad	True
cd	True
zedillo	False
diputación	False
catálogo	False
escapa	False
indignación	True
octavio	False
concluido	False
vaca	False
desempeño	False
hongo	False
permanentemente	False
afiliado	True
piscina	False
patronal	False
traducir	False
pintar	False
disolución	True
perfume	True
coraje	True
palo	True
expresamente	False
extremadamente	False
implacable	False
arreglo	False
trono	True
xv	False
obedecer	False
corbata	False
conceptual	False
tardar	False
exámen	False
fortalecer	True
seña	False
olímpico	False
muñeca	False
movilidad	False
preguntado	False
vejez	False
generado	True
desfile	True
sistemático	False
informática	False
leonor	False
anualmente	False
cotización	False
fomentar	False
desenlace	False
coyuntura	False
grabación	True
consuelo	False
lámpara	False
estatura	True
penetrar	False
examinar	True
predominio	False
atenas	False
editor	True
cajón	True
barato	True
radicalmente	False
distante	True
delincuencia	False
alejado	True
sustancial	False
relevancia	True
aviraneta	False
ordenamiento	False
nombrar	True
fabricante	True
seminario	True
inversionista	True
macho	False
consolidar	False
baloncesto	True
calificación	True
seleccionar	False
ayudante	True
preferible	False
ocio	True
char	False
plantel	False
estimular	False
suspender	False
procesamiento	True
reflexionar	False
barroco	True
envuelto	False
cortado	False
complemento	True
ingeniería	True
meramente	False
muslo	False
ascender	True
matemático	True
tendido	False
hembra	False
formalmente	False
penal	True
monseñor	False
poblado	False
vulgar	True
invención	False
jazz	True
conspiración	False
subvención	True
maleta	False
concedido	False
matanza	False
insoportable	False
pálido	False
atleta	True
generosidad	False
complutense	False
primordial	True
requerimiento	True
apropiado	False
veterano	True
asegurado	False
rodaje	False
hegemonía	False
setiembre	False
imposición	False
naturalidad	False
océano	False
inclinación	False
rechazado	False
fomento	False
faena	False
monarca	False
feroz	False
valiente	False
dialéctico	False
rastro	False
cobro	False
pulmón	True
vacuna	False
vencedor	True
portal	True
devolver	False
bombero	False
oliva	False
dueña	False
ángel	False
vencido	False
perseguir	True
orina	False
disgusto	False
terremoto	True
televisor	True
abismo	False
puño	False
patata	True
cruce	False
lealtad	False
monja	False
mejoramiento	False
aspirante	True
mediación	False
lucir	False
filial	True
bruscamente	False
sospecho	False
paja	False
fracción	True
desconocer	False
colmo	False
formulación	False
bondad	False
procurador	False
haití	False
molestia	True
extraña	True
asunción	False
asco	False
golfo	False
rencor	False
reaccionar	False
preservar	True
anillo	False
interlocutor	True
diseñado	False
patología	False
sonriente	False
anselmo	False
estrato	True
terapéutico	False
sobrino	False
guerrero	True
prestado	False
compensación	True
extendido	False
japón	False
ladrillo	False
contundente	False
enfermera	False
electorado	True
comisaría	False
susto	False
girar	True
fabricar	False
american	False
mama	False
ayudado	False
desagradable	False
cristóbal	False
clic	False
prejuicio	False
comparecencia	False
abstracción	True
consistencia	False
previsible	True
arreglar	False
camilo	False
ente	False
cia	False
belga	False
legalmente	False
oponer	True
monasterio	True
degradación	True
vestir	False
transformado	True
motivación	False
indiferente	True
cuna	False
bandeja	False
bruto	False
autora	False
anti	True
trance	True
poblador	False
porqué	False
injusto	False
sonrer	False
latín	True
inevitablemente	False
denunciado	False
incorporado	False
encerrado	False
contrabando	False
metodología	False
levantamiento	False
proso	False
eternidad	False
probado	False
indiscutible	False
sal	False
naval	False
átomo	True
articulación	True
impunidad	True
relevo	False
modesto	True
inmigración	False
euforia	True
agresividad	False
grabado	False
picada	False
muelle	False
balear	True
comparar	False
resultante	False
coca	False
azulgrana	False
ladrón	False
conquistar	False
atraer	False
devoción	False
laberinto	True
disponibilidad	False
puñado	False
che	False
extraer	True
pasaporte	False
supervisión	True
ramo	False
centavo	False
interrumpir	False
pinta	False
contienda	False
manta	False
medina	False
exclusión	False
narrador	True
recorte	False
aristótel	False
rotación	True
clemente	False
ordenación	True
instrumental	False
sucesivamente	False
procesión	False
sopa	False
corta	False
vestuario	False
cima	False
adoptado	False
admirable	False
armamento	False
chimeneo	False
descarga	True
apoyado	False
aspirar	False
telecomunicación	False
recipiente	True
orlando	False
pintado	True
total	True
conllevar	False
bolso	False
ida	False
confirmación	True
convención	False
niñez	False
goma	True
sumo	False
armario	False
sarajevo	True
continental	False
genial	False
invento	False
caridad	True
ceniza	False
soñar	False
compás	False
objetividad	False
negación	True
desequilibrio	False
originar	False
pabellón	False
inverso	True
novelista	False
comodidad	False
etarra	False
entraña	False
antepasado	False
reelección	False
alquiler	False
dividido	True
alterar	True
multa	False
verdad	True
camiseta	False
profundizar	False
siniestro	False
añadido	False
psicosis	False
uruguayo	False
razonamiento	True
roque	False
temática	False
marxismo	False
descartar	True
recomendable	False
llamamiento	False
siembra	False
mare	False
cuantía	False
remate	False
diferencial	False
vena	False
lata	False
estatuto	False
confundir	False
formular	False
aguantar	False
votante	True
replicar	False
salí	False
molde	False
autopista	True
imagino	False
derrotado	False
verter	False
jubilación	False
conversar	False
ario	False
desconcierto	False
pekín	False
prólogo	False
ratón	True
espontáneo	False
defensivo	False
cráneo	False
gravemente	False
mejoría	False
cristianismo	False
relleno	False
tinta	True
franja	True
párpado	False
gratuito	False
dividir	True
literalmente	False
nomás	False
auditorio	True
sinceridad	True
ajedrez	True
embarazado	False
físicamente	False
burlar	False
almirante	False
imaginario	False
competente	False
miserable	False
discreción	False
diferenciación	True
pianista	False
consigna	False
semejanza	False
deportista	False
matrícula	False
agonía	False
pronunciado	False
parroquia	False
extracción	True
proyectar	False
anotar	False
curación	False
manto	True
fijación	False
especulación	False
innovación	True
feo	False
provecho	False
burocracia	False
preferentemente	False
patrocinio	False
suscrito	False
sustancialmente	False
delgado	False
irme	False
expulsado	False
compartido	True
valía	False
cercanía	False
ético	True
jamón	True
segmento	False
centrar	False
operador	True
retroceso	True
pesar	False
matriz	True
caudal	False
virtual	False
gallina	False
nuboso	False
misil	True
controlado	True
suspendido	False
abstracto	True
maravilla	False
paulatinamente	False
esclavitud	False
superación	True
generoso	True
riguroso	False
biblia	True
insuficiencia	False
escudo	False
serrano	False
curar	True
reparación	True
escondido	False
intensamente	False
nieto	False
bestia	False
concretar	True
disimular	False
sodio	False
voluntariamente	False
preocupante	False
multinacional	False
freno	True
homicidio	False
hervir	False
heredero	False
indemnización	False
séptimo	False
profesorado	False
canela	False
paradoja	False
inventado	False
sencillez	False
compensar	False
excitación	False
caloría	False
estrés	False
homosexual	False
protegido	True
temía	False
afueras	False
diligencia	True
descender	True
hispano	False
celeste	True
borrar	False
quehacer	False
álbum	False
temprano	True
relacionar	False
involucrado	False
arranque	False
cómplice	False
bail	False
deseable	False
inquietante	False
legítimo	False
feto	False
industrialización	True
captación	False
acera	False
melodía	False
ordinario	True
narcotraficante	False
navegación	False
robado	False
iniciación	False
brigada	False
potable	False
precaución	True
inaugurar	False
pegar	False
gestación	False
fianza	False
toreo	False
presuntamente	False
centenario	False
dotación	False
monumental	True
ilustre	False
reparar	True
consecución	False
doctora	False
ecuación	True
mitin	False
esconder	False
detectado	False
minero	False
espíritus	False
rescatar	False
tomo	False
agotado	False
procuraduría	False
dudar	False
proporcional	True
decirtir	False
pasear	False
desigual	True
telón	False
cuaderno	False
sospechar	False
mono	False
cirujano	True
vitalidad	True
vicio	False
yema	False
utopía	False
valioso	False
mutuamente	False
dijistir	False
descubrimiento	True
desempeñar	False
reconstruir	False
tacto	True
enormemente	False
veneno	True
reconciliación	False
vertiente	False
estrechamente	False
dispersión	True
electrón	True
lámina	False
insólito	False
protocolo	True
temblor	False
cinturón	False
adaptar	True
higiene	True
palinuro	False
someter	False
helms	False
triángulo	True
criado	False
invertido	True
réplica	False
aluminio	True
américo	False
bata	False
confuso	False
enteramente	False
unánime	False
levemente	False
legado	False
aviación	True
cruzado	False
compasión	True
cortesía	True
trapo	False
convencimiento	True
rallado	False
coma	True
recesión	False
compatriota	False
cuadra	False
violín	True
alcoholismo	False
camarero	True
textura	False
quedo	False
reclamo	False
silueta	False
ecológico	False
explotar	True
nacho	False
asumido	False
bastón	False
especialización	False
racionalidad	False
metálico	False
frontal	True
rata	True
depresivo	True
crueldad	True
retención	True
despertado	False
renacimiento	True
soberbia	False
valle	False
auxilio	False
convergencia	True
saliva	False
facción	False
proliferación	False
nómina	False
olla	False
secuestrado	False
liquidación	False
lienzo	False
idiota	False
hormona	True
manga	False
apreciación	True
largamente	False
semanario	False
flexible	True
desacuerdo	False
atreverse	False
serpiente	True
correlación	True
prosperidad	True
escape	False
fotográfico	False
discreto	False
ministerial	False
cereal	False
crucial	False
pascual	False
sendero	True
canadiense	False
nudo	False
emisor	False
erosión	True
obligatorio	False
encabezar	False
cineasta	False
lavar	False
cauce	False
flamenco	False
rebaja	False
polo	False
descontento	False
economista	True
tope	False
simpático	False
indirectamente	False
demora	True
despejado	False
cueva	False
oyente	False
encerrar	False
hidrógeno	False
quieto	True
velada	False
amargo	False
dinámico	False
encender	True
administrar	True
soltar	True
geometría	True
recuento	False
tropical	True
mostrador	False
progresista	False
gradual	True
aurora	True
cuñado	False
prostitución	False
liberalización	False
tumor	True
jacinto	False
custodia	False
brisa	False
protestar	False
cohesión	True
extremidad	False
mate	False
fósil	False
cerco	False
cargar	False
insulto	False
decepción	False
tibia	False
cesar	True
proseguir	True
mayoritario	False
liberar	True
encendido	True
rendir	False
precioso	False
nativo	False
discrepancia	False
viabilidad	False
socialmente	False
sugerencia	False
contratar	False
lineal	True
vísperas	False
explosivo	False
agradecimiento	False
ventanilla	False
movido	False
formidable	False
descendiente	False
renovar	True
helado	False
dionisio	False
toma	False
escogido	False
vayas	False
bando	False
vener	False
espuma	False
vocal	False
gigantesco	False
batería	False
contribuyente	False
abastecimiento	False
aguja	True
codo	False
afortunadamente	False
inserción	False
talante	False
torpe	False
precipitación	False
recibo	True
rodar	False
interpretado	False
autorizado	True
dioso	False
incómodo	True
lucrecia	False
mudo	False
fracasado	False
suavidad	False
fugaz	False
activamente	False
regir	False
vitoria	False
despido	True
prescindir	False
francamente	False
dominación	True
implicación	False
designar	False
mozo	False
amoro	False
rentable	False
resaltar	False
calibre	False
originalidad	True
históricamente	False
vestíbulo	False
cocer	False
lucidez	False
fina	False
ezequiel	False
pipa	False
ceja	True
guapo	False
rebeldía	False
protector	True
opositor	False
cubrar	False
interrogante	False
tirado	False
restar	False
reproducir	False
envergadura	False
agitación	False
amarguro	False
devolución	True
vértigo	False
murmurar	False
alzar	True
disminuido	False
certificar	False
lío	False
estallido	False
extra	False
enfermería	True
asomar	False
prolongación	False
liberado	False
excursión	False
membrana	False
concentrado	False
cal	False
capricho	True
aconsejable	False
ascensor	True
cátedra	False
dinamismo	False
honestidad	False
verificar	True
contemplación	True
falsedad	True
sereno	True
acumulado	False
conformación	False
cautela	False
descomposición	True
lomo	False
viceversa	False
chorro	True
callado	False
camioneta	True
concha	False
agresivo	False
inventar	False
vocero	True
genero	False
auxiliar	True
biología	True
abanico	False
electo	True
polémico	False
carcajada	False
nutrición	True
despedir	False
opresión	False
comportar	False
defendido	False
cantabria	True
sincero	True
inmediaciones	False
velo	False
difunto	False
reinado	False
milla	False
oficio	False
encierro	False
incumplimiento	False
linda	False
nutriente	True
eguren	False
mixto	True
paradigma	False
realizador	False
consorcio	False
saludable	True
puntualizar	False
refuerzo	False
diversión	False
fortalecimiento	False
mezclar	False
jaula	False
silencioso	True
contratado	True
arrastrar	True
tele	False
saludar	False
incipiente	False
franquista	False
cañón	False
dominado	False
patricio	False
pastor	False
sequía	False
difundir	True
contraloría	False
show	True
metabolismo	False
etiqueta	True
extraordinariamente	False
concebir	False
ambigüedad	False
campana	False
soberano	False
súbito	False
bulto	False
kid	False
promotor	False
brindar	False
atributo	False
fray	False
irreversible	False
arterial	False
petrolero	False
diverso	False
contracción	False
rigidez	False
itinerario	False
cónsul	False
sartén	False
alfombra	True
tribu	False
adjunto	False
banquero	False
licitación	False
desigualdad	True
aliviar	False
indudablemente	False
guante	True
adjudicación	False
larra	False
compadre	True
