word	group_known
año	True
país	True
ver	True
caso	True
vida	True
hombre	True
forma	True
pasar	False
decir	True
presidente	True
hacer	False
mujer	True
mundo	False
querer	False
llegar	False
español	True
dejar	True
nacional	True
partido	False
persona	True
grupo	True
público	False
quedar	False
ir	False
mano	True
punto	True
millón	True
problema	True
dar	True
social	True
política	True
político	False
obra	False
salir	True
ciudad	True
encontrar	True
volver	True
seguir	True
pensar	False
sistema	True
importante	False
tipo	True
mes	True
económico	True
agua	True
cambio	False
derecho	True
alto	False
situación	True
frente	False
hablar	True
noche	True
poner	False
tomar	False
empresa	True
historia	True
padre	True
venir	False
fuerza	False
proceso	True
centro	True
relación	True
único	True
vivir	True
parecer	False
esperar	True
servicio	True
producir	True
palabra	True
pueblo	False
hijo	True
mantener	False
pequeño	True
cuerpo	True
permitir	False
siglo	False
nombre	False
mirar	False
sociedad	False
llevar	False
presentar	True
llamar	True
acción	True
ojo	True
creer	False
puesto	False
humano	True
niño	True
número	True
él	False
gente	True
ministro	False
semana	True
realidad	True
nivel	False
tierra	True
libro	True
programa	True
equipo	True
joven	False
resultado	True
desarrollo	True
proyecto	True
guerra	True
recordar	False
saber	False
actividad	False
razón	True
necesario	False
familia	True
estudio	True
zona	False
idea	True
tema	True
muerte	True
entrar	True
madre	True
internacional	True
condición	True
paso	False
interés	True
comenzar	True
principio	True
cabeza	True
calle	True
mañana	True
señor	True
información	True
sector	True
voz	True
don	False
buscar	True
sentir	False
puerta	True
medida	True
militar	True
efecto	True
director	True
movimiento	True
preguntar	False
posibilidad	True
mercado	True
empezar	True
viejo	False
fondo	False
orden	True
pedir	True
luz	True
resultar	True
aparecer	False
tratar	False
policía	True
peseta	True
hora	True
real	True
principal	False
imagen	True
miembro	True
llamado	False
blanco	True
recibir	True
actual	True
papel	True
amigo	True
especial	False
falta	True
comisión	False
campo	True
necesidad	True
cosa	False
camino	True
organización	True
seguridad	True
minuto	True
negro	True
comunidad	True
figura	False
acabar	True
europeo	True
capital	True
banco	True
decisión	True
producto	True
mayoría	True
perder	False
espacio	True
interior	True
servir	True
futuro	True
fuente	False
función	False
personal	False
oficial	False
investigación	True
popular	False
juego	True
objetivo	True
duda	True
libertad	True
base	True
clase	False
abrir	True
contar	False
arte	True
medio	False
lograr	True
conocer	True
difícil	True
pie	True
ocasión	False
ocurrir	False
objeto	True
elección	True
central	True
ofrecer	False
menor	False
jefe	True
causa	True
población	True
cultura	True
presente	True
música	True
dio	False
producción	True
médico	True
recurso	True
autor	True
dinero	True
línea	False
dirección	False
aspecto	False
precio	True
fuerte	False
muerto	True
color	True
convertir	True
santo	True
vista	True
presencia	True
distinto	True
considerar	False
asunto	False
autoridad	False
resto	False
civil	True
elemento	True
cara	True
consecuencia	True
acto	False
visto	False
carácter	True
gustar	False
dólar	True
diario	True
posición	True
peso	True
dato	True
argentino	True
julio	True
francés	True
gracia	True
hecho	False
natural	True
economía	True
común	True
caer	False
conocido	False
edad	True
cambiar	True
época	False
superior	True
conjunto	False
libre	True
experiencia	True
rey	True
especie	False
región	True
seguro	False
alcanzar	True
mostrar	True
llegado	False
comunicación	True
carta	True
capacidad	True
cumplir	True
serie	True
reunión	True
técnica	False
antiguo	False
mundial	False
contrario	True
término	False
entender	True
obtener	True
control	True
cargo	False
socialista	False
enfermedad	True
cantidad	False
opinión	False
referir	False
defensa	True
profesional	False
suponer	False
prueba	False
respuesta	True
utilizar	True
ganar	True
aire	True
terminar	True
jugar	False
artículo	False
prensa	False
cuarto	False
justicia	True
poder	False
privado	True
local	False
abierto	False
físico	True
crisis	True
malo	False
cuadro	False
evitar	False
realizar	True
mesa	True
operación	False
compañía	False
ministerio	True
unidad	False
televisión	True
izquierda	False
escribir	False
norteamericano	True
exterior	True
cuestión	False
área	False
administración	True
continuar	True
juez	True
material	True
largo	False
paciente	True
institución	False
salud	True
escuela	True
cultural	True
paz	True
trabajador	True
película	True
decidir	True
establecer	False
morir	False
estructura	False
metro	True
necesitar	False
educación	True
energía	True
ayuda	True
actitud	False
esfuerzo	True
nación	True
silencio	False
muestra	False
texto	True
conocimiento	False
histórico	True
responder	True
constituir	True
atención	True
allá	False
importancia	True
apoyo	False
científico	True
explicar	True
encuentro	False
formar	False
modelo	True
origen	True
hermano	True
declaración	True
suelo	True
extranjero	True
calidad	False
capaz	False
lucha	True
práctica	True
título	True
secretario	False
determinado	False
ciencia	True
brazo	True
máximo	False
bajo	False
escrito	False
solución	True
cine	True
animal	True
campaña	True
iniciar	True
propuesta	True
cabo	False
sueño	False
río	True
fecha	False
contenido	True
naturaleza	True
grave	True
ejército	False
sol	True
mar	False
especialmente	False
reforma	True
informe	True
materia	True
motivo	False
personaje	True
régimen	False
duro	False
electoral	True
interno	False
entrada	True
marco	False
éxito	True
señal	True
correr	True
incluir	False
carrera	False
expresión	False
concepto	True
organismo	True
vuelta	True
pobre	True
radio	True
sangre	True
domingo	True
particular	False
vía	True
ambiente	True
dirigente	False
familiar	False
corte	False
parte	False
soler	False
reconocer	False
formación	True
fiscal	True
diputado	True
característica	True
crear	True
cámara	True
responsable	True
democrático	True
representar	False
dolor	True
factor	True
tribunal	True
boca	True
mínimo	True
doctor	True
tercero	True
afirmar	True
américa	True
período	True
documento	True
planta	False
grado	False
arma	True
precisamente	False
técnico	False
señalar	True
existencia	False
ciudadano	True
jugador	True
líder	False
industria	True
suficiente	False
tratamiento	True
teatro	True
directo	False
mirada	False
aumentar	True
asociación	True
lleno	True
dispuesto	True
construcción	True
etapa	False
crecimiento	True
dirigir	True
actuar	False
puerto	True
deseo	True
sala	True
noticia	False
perdido	False
riesgo	True
plazo	True
derecha	True
asegurar	True
representante	True
momento	True
amplio	False
sacar	False
industrial	True
propiedad	True
funcionario	True
vino	True
claro	True
fácil	False
rojo	False
levantar	False
hija	False
escuchar	True
profundo	True
observar	True
inversión	True
leer	False
desarrollar	False
señora	True
norte	True
candidato	True
salida	False
sufrir	False
frío	True
tiempo	True
pleno	False
ejecutivo	False
participación	True
visita	False
página	True
juicio	True
finalmente	True
marcha	True
comercial	True
fundamental	True
municipal	True
armado	True
alemán	True
mitad	False
voto	True
sur	False
significar	False
grande	True
periodista	True
participar	True
responsabilidad	True
curso	True
aumento	True
dicho	False
crítica	True
miedo	True
terreno	True
oportunidad	True
contacto	False
existir	False
tarea	True
simple	True
comercio	False
pagar	False
valor	False
mayo	True
maestro	True
financiero	False
acerca	False
anunciar	True
memoria	False
conflicto	True
análisis	True
venta	True
presión	True
democracia	True
vecino	True
periódico	True
corazón	True
compañero	False
pretender	False
mayor	False
inmediato	False
golpe	True
mexicano	True
diferenciar	False
cama	True
profesor	True
carne	True
ocupar	False
completo	False
isla	True
negocio	True
estudiar	False
oposición	True
pese	False
declarar	False
aceptar	False
secreto	True
teoría	True
suceder	False
sujeto	False
favor	True
extremo	True
hospital	True
enero	True
artista	True
destacar	False
conciencia	True
atrás	False
rostro	True
dificultad	True
fenómeno	True
circunstancia	False
demanda	True
victoria	False
pensamiento	True
novela	True
estilo	True
lengua	True
diciembre	True
fuego	True
ingreso	False
preciso	False
provocar	False
mejor	True
creación	True
altura	True
adecuado	False
ejercicio	True
lista	False
concreto	True
previsto	False
negociación	True
error	True
indicar	False
suerte	False
club	True
método	True
enorme	False
corto	True
capítulo	True
demostrar	False
guardia	True
revolución	True
norma	True
cielo	True
voluntad	False
corresponder	False
sitio	False
edificio	True
departamento	True
traer	False
seguido	False
coche	True
herido	True
cifra	True
criterio	True
plano	True
entidad	True
normal	False
gesto	True
distancia	True
asimismo	False
aplicación	True
tocar	True
serio	False
permanecer	True
primero	False
junio	True
agente	True
tratado	True
pena	True
próximo	False
octubre	True
fiesta	True
judicial	False
inglés	True
fútbol	True
conversación	True
flor	False
actuación	False
beneficio	False
escena	True
década	False
mensaje	True
intención	True
destino	True
red	True
pieza	False
hotel	True
extraño	False
piedra	True
exposición	True
mover	True
peligro	True
comprender	True
similar	True
discurso	True
absoluto	False
religioso	True
violencia	True
presupuesto	True
víctima	False
provincia	True
moral	True
tradicional	False
corriente	True
andar	True
exigir	True
intervención	False
pérdida	False
general	True
territorio	True
nota	False
individuo	True
jamás	False
gasto	False
impuesto	True
alimento	False
doble	True
gusto	True
pintura	True
reciente	True
límite	True
definitivo	False
vehículo	True
poseer	True
oscuro	True
competencia	False
resolver	False
consumo	False
alma	True
instrumento	True
siguiente	False
positivo	False
básico	False
rápido	True
procedimiento	True
escritor	True
reunir	False
estudiante	True
vivo	False
par	False
detalle	True
propósito	True
instituto	True
revista	True
empresario	True
disponer	False
subir	True
masa	True
dirigido	False
correspondiente	False
abogado	True
verde	True
lenguaje	True
numeroso	False
oficina	True
tendencia	False
gestión	True
oro	True
presentado	False
hoja	True
versión	True
abril	True
moderno	False
complejo	True
pared	True
producido	False
referencia	False
influencia	True
sostener	True
actor	True
imposible	True
realizado	False
labor	True
marzo	True
disposición	False
reacción	True
jornada	False
sentimiento	False
cubano	True
septiembre	True
anterior	False
intentar	False
kilómetro	True
italiano	True
puro	True
ataque	True
superficie	False
alcalde	True
piel	True
visión	True
sombra	True
temporada	False
cerrado	True
celebrar	True
pierna	True
representación	True
trabajo	True
conducta	True
niña	True
teléfono	True
vacío	True
trabajar	False
depender	False
frase	True
tradición	True
oír	False
ventana	True
chino	True
caballo	True
sensación	True
compromiso	True
comité	False
transporte	True
noviembre	True
conducir	True
proponer	False
palacio	True
crédito	True
enfermo	False
contrato	False
advertir	False
habitación	True
temperatura	True
viento	True
doña	False
manifestación	True
rico	False
esperanza	True
cadena	True
justo	True
utilizado	False
regional	False
fase	False
negativo	False
específico	False
canal	True
colegio	True
instante	True
matar	False
ritmo	True
comunista	True
tono	True
surgir	False
colectivo	False
barrio	True
soldado	True
ámbito	True
pago	True
nacer	False
debate	True
citado	False
ley	True
delito	True
jurídico	False
diálogo	True
comienzo	True
intelectual	False
dedo	True
ayuntamiento	True
negar	True
sindicato	True
selección	True
urbano	False
relacionado	False
espíritu	True
legal	True
lunes	True
empleado	True
verano	True
árbol	True
mecanismo	True
agosto	True
azul	True
alumno	True
cerrar	True
entrevista	True
poeta	True
lugar	True
droga	False
contener	False
triunfo	False
vender	True
impedir	False
raíz	True
realmente	False
afectado	False
afectar	False
sábado	False
activo	True
considerado	False
ventaja	True
instalación	True
catalán	True
estrategia	True
directamente	False
vestido	True
apoyar	False
viernes	True
comida	True
confianza	True
personalidad	True
iniciativa	True
marido	True
caber	False
caja	True
frecuencia	False
espalda	True
totalmente	False
establecido	True
descubrir	False
clásico	False
piso	True
final	False
marca	True
evidente	True
escenario	True
unir	True
esposa	False
entero	True
generación	False
volumen	True
acceso	False
previo	False
detener	True
dormir	False
protección	True
comer	True
echar	False
deber	True
detenido	False
vivienda	False
franco	False
dedicado	True
pertenecer	False
presidencia	False
febrero	True
firma	False
lógico	False
junto	False
pareja	False
carretera	True
museo	True
federal	True
evolución	True
vasco	True
superar	True
pan	True
pelo	True
crecer	False
deuda	True
toro	True
sentar	False
defender	False
tasa	False
reducir	False
constante	True
independiente	True
destinado	False
determinar	True
externo	False
avión	True
hermana	True
café	True
elevado	False
oferta	True
abajo	False
cercano	False
bajar	False
diferencia	True
tecnología	True
original	True
calor	True
mamá	True
perspectiva	True
casa	True
querido	True
sesión	False
clave	False
definir	True
sonido	True
abandonar	True
obligado	False
sexual	False
feliz	False
aplicar	False
aparato	True
consistir	False
ropa	True
posterior	True
oído	True
eléctrico	True
estrella	True
titular	False
habitual	False
rato	False
respeto	True
hallar	False
cárcel	True
famoso	False
parlamentario	False
literatura	False
comportamiento	False
edición	True
asamblea	False
musical	False
convertido	True
órgano	True
enemigo	True
inferior	False
amenaza	True
artístico	False
signo	True
cuidado	True
preparar	True
división	True
loco	False
bolsa	False
fin	True
colocar	True
muchacho	False
fotografía	True
audiencia	True
preocupación	True
opción	False
repetir	False
seco	True
actualidad	True
laboral	True
expresar	True
recoger	True
constitucional	True
acudir	False
requerir	True
leche	True
interesante	True
desear	False
individual	True
recibido	False
costumbre	True
añadir	True
regresar	False
parque	True
accidente	True
carga	False
informar	True
británico	True
lector	True
deportivo	False
decidido	True
categoría	True
banda	True
deporte	True
espectáculo	False
frecuente	False
explicación	False
dedicar	True
falso	True
importar	False
medicina	True
agencia	False
semejante	False
enfrentar	True
permanente	False
relativo	False
foto	True
simplemente	False
adquirir	True
aceite	True
situado	True
fig	False
género	False
inicial	True
cubierto	False
haber	False
margen	False
lluvia	True
posible	False
sorpresa	True
tensión	False
huelga	True
prácticamente	False
imponer	False
alianza	False
publicado	False
gobernador	True
manifestar	False
tomado	False
recién	False
fórmula	True
habitante	False
conclusión	True
ausencia	True
denuncia	True
concepción	False
daño	True
escaso	False
dimensión	True
gol	True
llevado	False
compra	True
grito	True
efectivo	False
concluir	True
frontera	True
madera	True
elegido	False
gritar	True
solicitar	False
velocidad	True
argumento	True
acontecimiento	False
contribuir	True
tamaño	True
pecho	True
jardín	True
tío	False
regla	True
estatal	False
temor	False
letra	True
construir	True
independencia	True
hombro	False
impresión	False
esencial	True
salón	True
célula	True
probablemente	False
revelar	True
mejorar	True
martes	True
obligación	True
supremo	False
enseñanza	True
formado	False
cliente	True
insistir	True
ruido	True
posteriormente	False
cocina	True
máquina	True
misión	False
interpretación	True
síntoma	False
igualmente	False
protagonista	True
acompañado	False
estación	True
montaña	True
reina	True
parecido	False
identidad	True
aparte	False
hacienda	True
encargado	False
experto	True
anual	True
significativo	False
enviar	True
auténtico	True
olvidar	False
contestar	True
partida	False
canción	True
acompañar	False
unido	True
revolucionario	True
disco	True
pacto	False
funcionamiento	True
pintor	True
comprobar	True
reserva	True
aparición	False
excepción	True
registro	True
sustancia	True
protesta	True
sección	True
ideal	False
existente	False
incremento	True
liga	False
costo	True
lectura	True
componente	True
católico	True
distribución	True
suma	True
aprender	True
avance	True
sede	True
plata	True
liberal	True
estadounidense	False
jueves	True
portavoz	True
crítico	True
concentración	True
publicar	True
bello	True
huevo	True
incluido	False
punta	False
situar	False
continuación	True
confirmar	True
dado	True
chico	False
gas	True
obrero	True
federación	True
bien	False
asistir	True
fe	True
romper	True
lanzar	True
índice	True
preparado	True
ser	False
interesar	False
filosofía	True
marino	False
colombiano	True
introducir	False
amar	False
luna	True
facultad	False
postura	True
asesinato	False
virtud	False
excelente	False
presentación	True
comprar	True
ayudar	False
discusión	True
significado	True
localidad	True
acaso	False
acuerdo	True
búsqueda	True
crimen	True
occidental	True
vaso	True
testigo	False
socio	True
cuello	True
espejo	False
resolución	False
meter	False
labio	True
guardar	False
indio	True
ciclo	False
logrado	False
cita	False
notable	False
matrimonio	True
cristiano	True
compuesto	True
código	True
generalmente	True
caída	True
barco	True
desarrollado	False
misterio	True
convenio	True
creado	False
faltar	False
porcentaje	True
controlar	True
intervenir	False
acercar	False
nacido	False
reducción	True
culpa	True
sentado	False
batalla	True
comentario	True
mental	True
miércoles	True
pregunta	True
espectador	True
colaboración	True
mente	True
sentencia	False
educativo	True
consideración	False
múltiple	False
coincidir	True
chileno	False
decreto	True
recuperar	True
pasión	True
dueño	True
obligar	False
establecimiento	False
únicamente	False
entrega	True
asumir	True
triste	False
vuelto	False
intenso	False
desconocido	False
hermoso	False
literario	True
funcionar	False
plan	True
juventud	True
caliente	True
campesino	True
pendiente	False
organizado	True
inicio	True
inmediatamente	False
círculo	True
paisaje	True
automóvil	True
rueda	False
femenino	False
publicación	True
firme	False
equilibrio	True
ruso	True
presidencial	False
aprovechar	True
sencillo	False
ocurrido	False
integración	True
perfectamente	False
útil	True
desaparecer	True
recuperación	True
ánimo	True
calificar	True
composición	True
perfecto	True
petición	True
hogar	True
sonrisa	True
chica	False
fruto	True
preso	True
mandar	True
claramente	False
vuelo	True
tabla	False
terrorista	True
horno	False
depresión	True
policial	True
cuenta	True
peligroso	False
patria	False
corrupción	True
belleza	False
prisión	True
especialista	True
cadáver	False
auto	False
autónomo	True
sindical	True
esquema	True
conservar	True
papá	False
rasgo	False
plato	False
segundo	True
admitir	True
relato	True
tráfico	True
transformación	True
ordenar	True
modificación	False
potencia	True
atentado	True
azúcar	False
reflexión	True
pista	False
agregar	True
interesado	False
realización	False
gobierno	True
muchacha	False
clínico	True
resistencia	True
coronel	True
reconocimiento	False
universal	True
playa	True
observación	False
investigador	True
despertar	True
moneda	True
concierto	True
alegría	True
religión	True
silla	True
ejemplar	False
poesía	True
salario	True
seguramente	False
caminar	True
generar	True
fijar	False
municipio	True
clima	True
mando	False
conseguir	False
publicidad	True
eficaz	False
nervioso	True
alcance	True
capitán	True
puente	True
brillante	True
latino	False
garantía	False
torre	True
sexo	True
ganado	False
cooperación	True
productor	True
radical	False
universitario	True
planeta	True
preferir	False
utilización	False
apertura	True
anuncio	True
solidaridad	True
sometido	False
mencionado	False
encontrado	False
consciente	True
americano	True
obtenido	False
tren	True
cultivo	True
atender	True
senador	True
dulce	True
conseguido	False
telefónico	False
acusación	True
emoción	True
liberación	False
capa	False
rama	True
acusado	True
lento	True
escala	False
disciplina	False
conde	True
renunciar	True
alcohol	True
cubrir	False
extraordinario	False
consulta	False
contexto	True
curioso	True
diplomático	True
juzgado	False
rival	True
exportación	True
exceso	True
raro	False
borde	False
avanzar	False
hambre	True
regular	False
retirar	False
elaboración	True
débil	False
costar	False
tranquilo	True
vicepresidente	True
tía	False
pausa	True
aventura	True
bastar	False
hueso	True
proceder	False
alternativo	False
columna	True
paro	True
intensidad	True
exigencia	True
madrugada	True
rápidamente	False
invitado	True
poema	True
símbolo	True
desnudo	True
entorno	True
registrar	True
incorporar	True
motor	True
tiro	False
proporción	False
amarillo	True
cristal	True
amistad	True
procedente	False
turismo	True
impulso	True
cantar	True
aclarar	False
meta	True
ajeno	True
editorial	True
viajar	False
dominio	False
presunto	False
ensayo	True
nuevamente	False
reducido	True
núcleo	True
coger	False
completamente	False
madrileño	True
propietario	True
recientemente	False
roca	True
dependencia	True
elegir	False
despacho	False
salvar	False
variedad	True
adoptar	True
tienda	True
conservador	True
organizar	False
dibujo	True
mezcla	False
periodo	False
geografía	True
entregar	True
moda	True
festival	True
colonia	False
taza	True
coste	False
príncipe	True
seno	False
apartado	False
rechazar	True
mejora	True
terrible	True
usuario	True
traje	True
ilusión	True
productivo	True
nuclear	True
secretaría	True
ácido	True
tejido	False
gubernamental	False
convenir	False
gana	False
honor	True
placer	True
continuo	True
infantil	True
griego	True
escalera	True
analizar	True
diente	True
consejero	True
variable	False
terminado	True
amiga	True
fiel	False
evidencia	True
instrucción	True
inmenso	True
favorable	False
totalidad	True
aprobado	False
anciano	True
agricultura	True
contemporáneo	False
lesión	True
emisión	True
inteligencia	True
baño	True
bandera	True
vital	True
apuntar	False
olor	True
cerebro	True
preparación	True
basado	False
abuelo	False
risa	True
botella	True
bomba	False
obispo	True
global	True
informativo	False
absolutamente	False
contemplar	False
instancia	True
polvo	True
humor	True
enfrentamiento	True
conformar	True
naturalmente	False
fracaso	True
ceremonia	True
soviético	True
creciente	False
efectuar	False
violento	True
caracterizar	False
fila	True
delegado	True
regreso	False
proteína	True
déficit	False
quitar	False
suave	True
valer	False
solar	True
reconocido	False
diseño	True
suceso	True
galería	True
cumbre	False
correcto	False
testimonio	True
potencial	False
provincial	True
merecer	False
planteamiento	False
fundamentalmente	False
gloria	False
compartir	False
universo	True
escanda	False
alteración	False
secundario	True
definitivamente	False
teórico	True
extender	False
concesión	False
prima	False
recorrido	True
bloque	True
ejercer	False
llorar	True
oreja	False
comunicado	True
derrota	True
colección	True
amante	True
cierre	True
lejano	False
combate	False
definición	False
escolar	False
retrato	True
ambiental	True
formal	False
dosis	True
exclusivamente	False
embajador	True
muro	True
idioma	True
rodilla	False
inflación	True
residencia	True
soledad	True
eficacia	True
respectivamente	False
garantizar	False
rural	True
impacto	True
peruano	True
tender	True
fábrica	True
facilidad	True
ocupado	False
denominado	False
exactamente	False
autonomía	True
comentar	True
nacionalista	True
agrícola	True
especializado	False
eje	False
celebrado	False
asistencia	True
líquido	False
probable	False
duración	True
defensor	True
petróleo	True
invierno	True
laboratorio	True
tecnológico	False
encuesta	True
venezolano	True
nacimiento	True
pedido	True
preocupar	False
nariz	True
kilo	False
inútil	True
extensión	True
bar	True
tesis	False
afirmación	True
desaparecido	True
pantalla	True
paseo	True
administrativo	False
facilitar	False
implicar	True
ideológico	False
atractivo	False
visitar	True
cálculo	True
ejecución	False
episodio	True
incidente	False
oy	False
químico	True
plantear	False
tirar	False
imperio	True
convencido	True
ruta	True
imaginación	True
estabilidad	True
castellano	True
adolescente	True
tarjeta	False
orgullo	True
músico	True
reflejar	True
sonreír	False
reflejo	True
fruta	False
emisora	False
limpio	True
visitante	True
condenado	True
abundante	True
distrito	True
claridad	True
estímulo	False
redacción	True
solicitud	True
canto	True
estético	False
empresarial	True
novedad	True
cura	False
beber	False
hierro	True
riqueza	False
grasa	True
sonar	False
senado	False
promedio	True
temporal	True
cometido	False
patio	True
otan	False
tropa	False
consumidor	True
nube	True
mencionar	False
integrado	False
académico	True
hipótesis	True
sólido	False
cruzar	False
árabe	True
músculo	True
orquesta	True
monte	False
diagnóstico	True
expectativa	True
rechazo	True
colega	False
pesado	True
ilegal	True
limitar	True
restaurante	True
respectivo	False
supuesto	False
romano	True
excesivo	True
institucional	False
sacerdote	True
retirado	False
distinguir	True
progreso	True
remedio	True
vegetal	False
piloto	True
fortuna	True
aeropuerto	True
abuela	True
marcado	True
camión	True
rendimiento	False
templo	True
adulto	True
republicano	True
subrayar	False
sanción	True
difusión	True
cucharada	True
mantenimiento	True
latinoamericano	True
estrecho	False
pobreza	True
bolsillo	False
prestigio	False
patrón	False
transición	True
uniforme	True
cumplimiento	True
cantante	True
gris	True
pensión	False
avenida	True
lentamente	False
satisfacción	True
medicamento	True
mentira	True
paquete	False
viaje	True
dictadura	True
comunitario	False
salto	True
vigente	False
indígena	True
cáncer	True
hilo	True
descenso	False
entusiasmo	True
ideología	True
recuerdo	False
iniciado	False
variación	True
explotación	True
manejo	False
judío	False
imaginar	False
asiento	True
aprobación	True
aprobar	False
acusar	True
luchar	False
representado	False
conveniente	True
mediado	False
candidatura	True
rumor	True
acordar	False
torneo	True
parcial	False
universidad	True
enseñar	False
polémica	False
particularmente	False
atmósfera	False
pasillo	True
descubierto	True
conductor	True
estadio	True
infección	True
efectivamente	False
circulación	True
separar	True
sospecha	True
aficionado	True
rincón	False
campeón	True
manifiesto	True
feria	True
exponer	False
trato	False
trastorno	True
taller	True
hábito	False
sanitario	False
ingrediente	True
humanidad	True
fácilmente	False
conceder	True
poderoso	False
infancia	True
sensible	True
obstáculo	True
rayo	True
pasado	True
rumbo	False
verso	True
ejemplo	False
decisivo	True
legislación	False
plástico	True
magistrado	True
limitación	True
campeonato	True
operar	False
tela	True
demostrado	False
justificar	False
pájaro	True
promesa	True
sierra	False
alimentación	True
esquina	True
expansión	True
exclusivo	False
vacaciones	True
alcanzado	False
clasificación	False
reloj	True
banca	False
concejal	True
ingeniero	True
corredor	True
arena	True
anteriormente	False
comandante	True
cotidiano	False
contradicción	True
homenaje	True
gravedad	False
limitado	False
importación	True
espectacular	False
mero	False
baja	False
litro	True
sensibilidad	True
lágrima	True
estancia	True
héroe	True
profundidad	True
emitir	False
anunciado	False
autonómico	False
disminuir	False
expediente	False
tabaco	True
renta	False
concurso	True
nave	True
angustia	True
directivo	False
restante	True
terrorismo	True
cigarrillo	True
trasladar	True
sacrificio	False
evaluación	True
felicidad	True
modalidad	False
oscuridad	False
aportación	True
culpable	True
describir	True
virus	True
caballero	False
incapaz	True
previamente	False
combinación	True
partidario	True
destacado	False
permiso	True
vivido	False
cena	True
raza	True
ampliación	True
noble	True
sufrido	False
fino	False
orilla	True
teniente	True
viajero	True
vencer	False
equivalente	False
corona	True
incendio	True
llave	True
dignidad	True
depósito	True
crónica	False
docente	True
fantasma	False
defecto	True
biblioteca	True
militante	True
humo	True
firmar	False
espacial	False
ancho	False
cartel	False
cuerda	False
cuota	False
fresco	True
precisar	False
ópera	True
continuidad	True
cualidad	False
pantalón	True
cuadrado	True
tonelada	False
igual	False
dama	False
gen	False
comprensión	True
metal	False
logro	True
convocatoria	True
profesión	True
regalo	True
plante	False
entrenamiento	True
requisito	True
gato	True
bebida	False
coalición	True
descanso	True
promoción	True
aprendizaje	True
identificar	True
continente	True
tarifa	True
síntesis	False
ligero	False
evento	True
arquitectura	True
visible	True
aislado	False
integrante	False
mineral	True
orientación	True
destrucción	False
bancario	True
primavera	True
confusión	False
huella	True
proporcionar	False
financiación	True
panorama	True
guerrillero	True
permitido	False
relativamente	True
disponible	False
celebración	True
ordenador	True
disparo	False
anoche	False
cabello	True
disminución	False
vinculado	False
separado	False
oculto	True
inquietud	True
afuerar	False
milagro	True
curiosidad	False
mediodía	True
arco	True
circuito	False
placa	True
creador	True
absurdo	True
ernesto	False
embajada	True
patrimonio	False
proteger	True
mérito	False
juvenil	False
fantasía	True
construido	True
carecer	False
onda	True
palma	False
adelantar	False
sueldo	True
centenar	False
compositor	True
desaparición	True
colaborador	True
gira	False
aéreo	False
sumar	False
precedente	True
maniobra	False
semilla	True
aceptado	False
investigar	True
cinta	True
temer	False
criminal	True
genético	False
pensado	False
programación	True
prever	True
estable	True
durar	False
definido	False
sorprender	False
integrar	False
inocente	True
dios	False
aliado	False
estructural	False
conexión	True
cobrar	True
mandato	True
mapa	True
creencia	True
oriental	True
verdadero	True
beso	True
suficientemente	False
consenso	True
necesariamente	False
eterno	False
fama	True
casado	False
emperador	True
mecánico	True
intérprete	True
curva	True
harina	True
aportar	False
igualdad	True
avanzado	True
varón	True
pecado	True
sabor	True
oeste	True
posesión	False
vídeo	True
pata	True
delegación	True
mito	True
bolívar	False
fundamento	True
israelí	True
lateral	True
copia	False
carro	True
setenta	True
agresión	True
leve	False
legislativo	False
reglamento	False
suizo	True
primario	False
vigor	True
lujo	True
corresponsal	True
asesino	True
percepción	True
león	True
fijo	False
ala	True
perro	True
rigor	False
recorrer	False
escultura	True
estadística	True
plaza	True
prestar	False
digno	True
ubicado	False
vigilancia	True
excepcional	False
sucedido	False
dominante	True
archivo	True
esencia	True
variado	False
rebelde	True
exacto	False
geográfico	True
bonito	False
eliminar	True
brasileño	True
guerrilla	True
interpretar	True
trámite	True
medir	False
adicional	False
marcar	True
tramo	False
horario	True
trozo	True
dormido	False
cortar	True
denunciar	False
caído	False
visual	True
dieta	True
firmado	True
comerciante	True
asesor	False
narcotráfico	False
asistente	True
xx	False
dinámica	False
arquitecto	True
apreciar	True
electrónico	True
siquiera	False
préstamo	False
turno	True
manejar	True
constituido	False
calma	True
intercambio	True
conservación	True
combustible	True
enviado	False
odio	True
olvidado	True
pescado	True
examen	True
gobernante	False
abuso	True
registrado	True
jugado	False
zapato	True
multitud	True
precisión	False
monetario	False
rodear	False
imprescindible	False
revisión	True
gota	False
artificial	True
baile	True
secuencia	False
aporte	False
derivado	False
entrenador	True
esfera	True
ángulo	True
verdaderamente	False
queja	True
complicado	True
estimar	True
ave	False
previsión	True
profundamente	False
danza	True
ética	True
ruptura	False
identificación	True
castigo	True
percibir	True
mortal	True
tel	False
sucesivo	False
separación	False
herramienta	True
perfil	True
recto	False
apariencia	True
respaldo	False
masculino	False
península	True
violación	True
pacífico	False
horizonte	True
bienestar	True
ciego	False
vitamina	True
párrafo	True
aparentemente	False
condena	True
lección	True
detención	False
camisa	False
tragedia	True
aspiración	False
japonés	True
transformar	True
alternativa	False
comparación	True
tve	False
rodeado	True
sustituir	False
masivo	False
favorecer	False
desgracia	True
privilegio	True
participante	True
voluntario	True
ciertamente	False
sano	False
contaminación	True
íntimo	False
terrestre	False
elevar	True
ligeramente	False
humedad	True
inconveniente	False
queso	True
grano	False
autobús	False
medalla	True
ola	True
tristeza	True
lado	True
delicado	False
vergüenza	False
opuesto	False
fibra	False
infinito	False
socialismo	True
satélite	True
pluma	True
trayectoria	True
secuestro	False
diablo	False
inevitable	True
cebolla	True
suspensión	True
alza	False
descripción	True
finalidad	False
tomate	True
actriz	False
expuesto	True
cola	True
posiblemente	False
amparo	False
provocado	False
prioridad	False
maíz	True
mancha	False
infraestructura	True
urgencia	True
tranquilidad	False
progresivo	True
xviii	True
torero	True
causar	True
experimento	True
sexto	False
nieve	True
funcional	False
atravesar	False
terror	True
ap	False
incorporación	True
antecedente	True
grueso	False
negociar	False
bosque	True
típico	False
vocación	False
observador	True
piano	True
normalmente	False
instalado	False
granada	False
intento	False
receptor	False
licencia	True
pasajero	True
balance	True
ganancia	False
plenamente	False
domicilio	True
aceptación	False
dramático	False
km	True
adiós	True
fotógrafo	True
oriente	True
votación	False
titulado	False
divisa	False
elemental	False
gordo	False
agudo	False
emergencia	True
subida	False
premio	True
quinto	True
componer	False
singular	False
pelota	True
parar	True
preferencia	True
convivencia	False
mina	False
guía	True
ansiedad	True
barrera	True
inteligente	True
ruina	False
novio	True
acceder	False
olvido	True
transferencia	True
talento	True
evidentemente	False
sucio	False
poético	True
vanguardia	True
magnífico	False
cm	True
casco	True
invitar	True
considerable	True
cero	True
dominar	False
desierto	True
exilio	True
pretensión	False
psicológico	False
propuesto	False
espiritual	True
aplicado	False
adaptación	True
botón	True
contraste	True
adentro	True
vela	False
desempleo	True
otorgar	True
perteneciente	False
prestación	False
izquierdo	False
salsa	True
fragmento	True
represión	False
tesoro	True
et	False
pedazo	False
locura	False
transmitir	True
recomendación	True
modificar	True
comisario	False
buque	True
novia	True
caza	True
proyección	False
combatir	True
doctrina	True
ingresar	True
abandono	True
urss	True
filósofo	True
explosión	True
renovación	True
llenar	True
muscular	False
química	True
transmisión	True
variar	False
corporación	True
billete	False
estricto	True
usado	False
determinación	False
convencional	False
pez	True
rapidez	True
sombrero	True
estómago	True
parado	False
paciencia	True
ronda	False
escapar	True
debilidad	True
miseria	False
indispensable	False
sugerir	False
otoño	True
montar	False
ocupación	False
magnitud	True
generalizado	False
corrida	False
biológico	True
acá	False
minoría	True
fusión	False
recogido	False
limpieza	True
prometer	False
herencia	True
pilar	True
paralelo	False
misa	True
cariño	True
deterioro	True
utilidad	True
culto	True
calcular	False
soberanía	True
abandonado	False
aniversario	True
turista	True
tránsito	False
incidencia	True
vigencia	False
gráfico	True
aparente	False
saltar	True
afán	False
documentación	True
prisa	False
personalmente	False
jurado	True
legislador	True
sagrado	False
recurrir	False
conquista	True
escritura	False
comando	False
costado	False
regulación	False
oficialmente	False
relevante	True
historiador	True
convicción	True
ucd	True
mercancía	False
finanzas	True
introducción	False
turístico	False
hallazgo	True
reclamar	False
esposo	True
discutir	False
declarado	False
retorno	False
pistola	True
gerente	False
cómodo	False
planificación	True
brusela	False
constantemente	False
censura	True
art	True
manzana	True
resumen	True
mágico	True
nombrado	False
maravillo	False
energético	False
movilización	True
nicaragüense	True
enfoque	False
corporal	True
reparto	False
sumamente	False
agrupación	False
síndrome	True
diversidad	True
coordinación	False
balón	True
relieve	False
urgente	True
pasaje	False
gramo	True
mueble	True
variante	False
promover	True
salvaje	True
burguesía	False
viuda	True
móvil	True
centímetro	True
vínculo	True
rubio	False
fiebre	True
acostumbrado	True
longitud	True
moderado	False
circular	False
cartera	False
ajuste	False
vientre	False
andaluz	True
soportar	False
extenso	False
fuga	False
mensual	False
metido	False
convocado	False
adquisición	False
vidrio	True
monumento	True
sorprendente	False
respiración	True
resistir	False
adn	True
elaborado	False
ajo	True
basar	False
provenir	False
integral	False
solitario	False
pronunciar	False
fallo	False
recinto	False
directiva	True
agradable	True
nombramiento	True
húmedo	True
indígeno	False
fabricación	True
señorita	False
india	True
comicio	False
xvii	False
autorización	True
traslado	True
boda	True
caldo	True
embarazo	True
molécula	True
casar	False
monarquía	True
molesto	False
hierba	False
habilidad	True
ahorro	True
divino	True
cintura	False
cinematográfico	False
reservado	False
basura	False
alicia	False
miel	True
asociado	False
cerveza	True
mediano	False
ampliar	False
públicamente	False
esclavo	True
infierno	True
foco	True
tremendo	False
sillón	False
eliminación	True
convocar	True
té	True
civilización	False
válido	False
valoración	True
certeza	False
demócrata	True
justamente	False
récord	True
doméstico	True
limón	True
refugio	True
libra	True
constar	False
deficiencia	True
oxígeno	True
complejidad	True
sustitución	True
prolongado	False
reivindicación	False
azar	False
nervio	True
confesar	True
prisionero	True
demonio	True
recepción	True
figurar	False
propaganda	True
calendario	True
aliento	False
significación	False
inspector	True
bala	False
usar	False
ascenso	True
manera	True
guión	False
retraso	True
leyenda	True
dimisión	False
mejilla	False
eco	True
revés	False
fundado	False
americana	False
admiración	True
comunicar	True
publicitario	False
instalar	False
estrictamente	False
plantilla	False
mariano	False
disfrutar	True
perfección	False
cancha	True
vendedor	True
mierda	False
romántico	False
encargar	False
crema	True
enterar	False
repercusión	True
denominar	True
decena	False
toque	True
carbón	True
rito	False
cobertura	False
padecer	False
favorito	False
alegre	True
soporte	False
gozar	True
montaje	True
ofensiva	False
espada	True
racional	True
invasión	True
puta	False
sucesión	False
acumulación	False
afición	True
entendido	False
trimestre	True
receta	True
presidido	False
consejo	False
rango	True
increíble	True
partir	False
disparar	False
inesperado	True
africano	False
cementerio	True
creativo	False
hielo	True
prevención	True
transcurso	False
frecuentemente	False
rock	True
confiar	True
aviso	False
asalto	True
supervivencia	True
perdón	True
atento	False
selva	True
satisfacer	True
distinción	False
falla	True
canciller	False
dispositivo	True
reto	True
refugiado	True
fraude	True
orgánico	False
seleccionado	False
fiscalía	True
capitalismo	True
ligado	False
sorprendido	True
cansancio	True
inicialmente	False
normativa	True
discípulo	False
rabia	False
reproducción	True
célebre	False
roto	False
seguimiento	False
intimidad	True
doloroso	False
cuenca	False
drama	False
consumir	False
criticar	False
colonial	True
básicamente	False
filme	False
adquirido	False
dorado	False
densidad	True
cuartel	False
cuento	True
prenda	False
adversario	False
barro	True
asesinado	False
llama	False
trágico	False
quinta	True
entendimiento	False
afrontar	False
barra	True
tumba	True
procesado	False
correo	True
hectárea	True
pasta	True
simultáneamente	False
probar	False
almuerzo	True
bahía	False
vano	False
primitivo	False
horror	True
seguidor	True
permanencia	False
pelea	False
prd	False
dormitorio	False
redondo	False
habitualmente	False
incertidumbre	True
listo	False
sonoro	False
privatización	True
elegante	False
and	True
comedor	True
peculiar	True
simbólico	False
teatral	False
tronco	True
empeño	False
repetido	False
influir	True
tercio	True
irregularidad	True
alejar	True
kg	True
vapor	True
razonable	True
propiamente	False
quibir	False
ganador	True
incapacidad	False
invitación	True
choque	True
garganta	True
productividad	True
robo	True
elaborar	False
asombro	True
respetar	False
bailar	True
bosnia	True
tarde	False
estratégico	False
almacén	False
manteca	False
censo	True
aislamiento	True
manolo	False
juzgar	True
nocturno	True
optar	False
jugo	True
enmienda	False
amanecer	False
huir	True
notar	False
genio	True
satisfecho	False
atlántico	False
tentación	True
entregado	False
secretaria	True
costa	False
severo	True
indicación	False
inés	False
provisional	True
empate	True
alarma	True
cuchillo	True
oral	False
trama	True
referente	True
giro	True
presa	True
parto	True
supuestamente	False
noción	False
directora	False
futbolista	True
cuero	True
ciudadanía	True
cocción	False
modo	False
sabiduría	True
preocupado	False
maldito	False
problemática	False
acento	True
indiferencia	True
helicóptero	True
desastre	True
fundar	False
reuter	False
citar	False
sudor	True
idéntico	False
ficción	True
ocultar	True
comedia	True
cortina	False
desesperado	True
manifestado	False
fachada	False
monto	False
inspiración	True
ternura	False
cansado	True
estallar	True
reír	False
planteado	False
desesperación	True
accionista	True
montón	False
tocado	True
nacionalidad	True
sufrimiento	True
votar	True
cerro	True
broma	True
afecto	True
rol	True
alba	True
suicidio	True
vertical	False
mandatario	False
psicología	True
correspondencia	False
pesca	True
marchar	False
electricidad	True
bebé	True
coro	True
postre	True
filosófico	True
asilo	True
alcaldía	False
colocado	False
contento	False
hueco	False
flujo	True
bordo	False
obtención	False
peor	False
endor	False
solucionar	False
delincuente	True
capitalista	True
mutuo	False
informado	False
film	True
caos	False
desafío	True
territorial	True
tormenta	True
diana	False
finca	True
traducción	True
rosario	False
finalizar	True
fuertemente	False
contribución	True
ajenar	False
partícula	True
madurez	True
inmigrante	True
incrementar	True
confederación	True
inspección	False
celular	False
gobernar	False
cocaína	False
terapia	True
taxi	True
uso	False
ignorar	True
acero	True
importe	False
altamente	False
impresionante	True
moder	False
mediterráneo	True
agenda	True
picado	False
balcón	True
difícilmente	False
lecho	False
clarín	False
plataforma	False
sandinista	True
vegetación	True
fortaleza	True
ignorancia	True
cable	True
prado	True
persecución	True
saco	False
captura	True
abundancia	True
inauguración	True
implantación	True
optimismo	True
completar	True
malestar	True
ridículo	True
venganza	True
ampliamente	False
deriva	False
emocional	True
docena	False
centroamérica	True
arrancar	False
desprecio	True
convencer	False
énfasis	True
cobre	True
concretamente	False
mal	False
financiamiento	False
copa	False
diámetro	True
crudo	False
nostalgia	True
parcialmente	False
ministra	False
grabar	True
indicio	True
alrededor	False
rescate	True
referéndum	True
sobrevivir	False
competir	True
lago	True
casualidad	False
contratación	False
alivio	True
alerta	True
oportuno	True
residir	False
residuo	True
trascendencia	True
mortalidad	True
probabilidad	True
fidelidad	True
ausente	False
flota	False
simpatía	False
algodón	True
eficiencia	True
obvio	False
estreno	True
liderazgo	True
lanzamiento	True
operativo	False
primo	False
apellido	True
modernización	True
ironía	True
cruel	False
ofrecido	False
coordinador	True
bloqueo	True
aborto	True
puramente	False
nacionalismo	True
eventual	False
reagan	True
amable	True
billón	False
perjuicio	True
brillo	True
pañuelo	True
excesivamente	False
conducción	False
excelencia	True
expulsión	True
últimamente	False
cerebral	True
desorden	False
retiro	True
expresado	False
exclamar	False
carencia	True
hígado	True
acercamiento	True
cc	False
prohibición	True
normalidad	False
bronce	False
carbono	True
transparente	True
presidir	False
magia	True
disputa	True
destruir	False
cúpula	False
consolidación	False
inconsciente	False
respectar	False
podero	False
sencillamente	False
denominación	True
verbal	False
muchísimo	False
inmóvil	False
riego	True
conferencia	True
trago	False
credibilidad	True
seda	True
pretexto	True
firmeza	False
inocencia	True
escasez	True
ritual	True
indicado	False
coincidencia	True
rehén	False
tubo	True
colón	False
vaticano	True
continuamente	False
convento	False
cerdo	True
esencialmente	False
atribuir	True
llanto	True
desconfianza	True
desayuno	True
libremente	False
fijado	False
colaborar	True
seriamente	False
leir	False
aparecido	False
licenciado	True
antena	False
maestra	False
iglesia	True
tolerancia	True
competición	False
evaluar	True
validez	False
rentabilidad	False
marcador	False
abordar	False
atracción	False
prohibido	True
configuración	False
órbita	False
gama	False
creatividad	False
jacque	False
fujimori	True
cosecha	True
considerablemente	True
pagado	False
chocolate	True
despedida	True
superado	False
detectar	False
realismo	True
descansar	False
levantado	False
fumar	True
adhesión	True
ubicación	True
inseguridad	True
mm	False
cardenal	True
salarial	False
inclusive	True
aproximación	True
penumbra	True
sumario	True
trigo	True
experimentado	False
causado	False
transparencia	True
reposo	True
cenar	False
majestad	False
reconstrucción	True
formato	False
insuficiente	True
práctico	False
celda	False
residente	True
políticamente	False
pollo	False
fundador	True
imposibilidad	False
enferma	True
repertorio	False
repetición	True
revisar	True
gala	True
rector	False
diariamente	False
terraza	True
escritorio	True
esperado	False
jerusalén	True
enamorado	False
capilla	False
cerámica	True
prevenir	False
pico	True
pesadilla	True
suavemente	False
duelo	True
pánico	False
delantero	True
retórica	False
invisible	False
cirugía	True
indudable	False
designación	True
jerarquía	False
pusar	False
trampa	True
recomendar	False
protagonismo	False
antigüedad	True
justificación	True
fallecido	False
reiterar	True
específicamente	False
dureza	True
rebelión	True
corregir	True
aldea	True
conveniencia	False
expedición	True
breve	True
gasolina	True
crecido	False
pimienta	True
dictador	True
perejil	True
presidenta	False
realista	True
ceder	False
vinculación	False
serenidad	True
analista	True
reforzar	True
adopción	True
extradición	True
rehabilitación	True
aplauso	True
modernidad	False
empleo	True
áfrico	False
invertir	True
maquinaria	True
discriminación	True
semestre	True
legalidad	False
ambición	True
comunismo	True
fatal	True
marqués	True
frenar	False
tenis	True
gafas	True
insecto	False
lamentable	False
sargento	False
instinto	True
falda	False
envidia	True
inscripción	True
restricción	True
demostración	False
volar	True
mención	True
gigante	True
uña	False
espectro	True
averiguar	False
opinar	False
pulso	False
adolescencia	True
complicación	False
balanza	True
gallego	True
experimental	False
caña	False
constancia	False
manipulación	True
coherente	True
seriedad	False
portero	True
merced	False
patente	True
óptico	True
característico	False
radicar	True
jurisdicción	True
horizontal	True
asociar	False
financiar	False
captar	False
suelto	False
obsesión	True
palestino	True
confrontación	True
sucesor	True
horrible	False
agujero	True
reportaje	True
divorcio	True
menú	True
cuidadosamente	False
pescador	True
grandeza	False
emprender	True
tapa	True
árbitro	True
tregua	False
compañera	True
popularidad	False
surgido	False
urna	False
auge	True
tradicionalmente	False
barba	True
sofá	True
fresca	False
celo	False
biografía	True
matiz	False
independientemente	False
desprender	True
comprometido	False
inminente	False
princesa	True
apuesta	True
rosa	True
humilde	True
pce	False
salvación	False
eficiente	True
irregular	True
abiertamente	False
complicidad	True
amor	True
radiación	True
emplear	False
innumerable	True
insistencia	False
tour	True
furia	False
pauta	False
valorar	False
encargo	True
elector	True
cese	False
sed	False
abrigo	True
porvenir	False
salina	False
trayecto	False
lanzado	False
participado	False
armar	False
descrito	False
ira	True
corteza	True
parámetro	True
comprendido	False
preferido	False
prudencia	True
equivaler	False
liberalismo	True
impulsar	False
verdura	False
unanimidad	True
mantequilla	False
sello	False
caro	True
injusticia	True
saldo	True
ríe	False
calcio	True
conocí	False
arzobispo	True
interacción	True
proveniente	False
cargado	False
restauración	False
túnel	True
implicado	False
deseado	False
papas	False
pariente	True
comercialización	False
rutina	False
integridad	True
correctamente	False
timbre	False
monopolio	True
pc	False
competitividad	True
torno	False
alusión	True
aprovechamiento	False
coherencia	True
respirar	True
designado	False
atacar	False
mentalidad	True
impotencia	False
sostenido	False
plenitud	False
anterioridad	False
escaño	True
conjuntamente	False
transcurrir	False
proposición	True
consultar	False
rtve	False
especialidad	False
fallecer	False
esplendor	True
joya	True
narración	True
manual	True
juro	False
enlace	False
marxista	True
vinir	False
pta	False
documental	True
dotado	True
altar	True
porción	True
practicar	True
bono	False
exactitud	False
apartamento	True
progresivamente	False
envío	True
catedrático	False
sobra	False
narrativa	True
doler	False
amplitud	True
abarcar	False
bola	True
procedencia	False
ordenado	False
extinción	True
veras	False
adecuadamente	False
sentimental	True
buscado	False
frustración	True
trazado	False
talla	False
ingenio	True
tim	False
atardecer	True
ejecutar	False
colocación	False
duque	True
advertencia	True
engaño	True
dependiente	True
exploración	False
hondo	False
comir	False
optimista	True
interminable	True
dedicación	True
saludo	True
agricultor	True
excusa	True
bota	False
lana	True
pozo	True
plomo	False
inversor	True
comarca	True
debido	False
cuidar	True
lástimo	False
víspera	False
legitimidad	True
elegancia	True
cometer	False
dictamen	False
proximidad	False
lazo	False
quiebra	False
brutal	True
consiguiente	False
acierto	False
legislatura	False
tortura	True
administrador	True
saint	False
moción	False
culo	False
agrario	False
conformidad	True
abrazo	True
umbral	True
borracho	True
traición	True
cucharadita	False
exhibición	True
consistente	True
franquismo	True
efectividad	False
notablemente	False
lingüístico	False
nuca	False
parada	False
confirmado	False
reestructuración	True
conversión	True
niebla	False
whisky	True
terminal	True
obviamente	False
superioridad	False
supresión	True
inestabilidad	True
revelación	False
metáfora	False
decoración	True
negado	True
natal	False
identificado	False
holandés	True
prudente	True
recuperado	False
aroma	True
capacitación	True
musulmán	False
sabio	True
fármaco	False
organizador	True
absorción	True
decadencia	False
superficial	True
manifestante	True
cemento	True
lavado	False
solemne	False
intermedio	True
querella	False
pronóstico	False
lentitud	True
encanto	False
sutil	False
debidamente	False
inclusión	True
oración	False
equivocado	False
serbio	True
medellín	True
económicamente	False
portugués	True
catástrofe	True
entierro	True
cocinar	True
monstruo	True
fauna	True
pureza	True
elevación	False
aceptable	False
fatiga	True
indicador	True
sábana	False
lema	False
medieval	True
digital	True
hagar	False
flexibilidad	True
tenor	True
apetito	False
acogida	False
chaqueta	True
comprado	False
pa	False
colesterol	False
certamen	False
reunido	False
frágil	True
urbanización	False
factura	True
harto	False
amnistía	False
confesión	True
despliegue	False
cabecera	False
delirio	False
determinante	False
anécdota	True
volante	False
bacteria	True
divertido	False
cumpleaños	True
insomnio	True
táctica	False
subido	False
nobleza	False
penetración	False
subasta	True
suministro	False
lógicamente	False
melancolía	True
lapso	False
ferrocarril	True
acordado	False
huida	True
piedad	False
subsecretario	True
localización	False
automáticamente	False
clausura	False
escoger	False
heroína	True
campamento	True
leña	False
recaudación	True
mérida	True
vinagre	True
acta	True
mármol	False
corrección	True
cartón	True
creído	False
portada	True
potente	True
iluminación	False
limpiar	True
medianoche	False
efectuado	False
intuición	True
sexualidad	True
cd	False
zedillo	False
diputación	False
catálogo	False
escapa	False
indignación	True
octavio	False
concluido	False
vaca	False
desempeño	False
hongo	True
permanentemente	False
afiliado	True
piscina	True
patronal	False
traducir	False
pintar	True
disolución	False
perfume	True
coraje	True
palo	True
expresamente	False
extremadamente	True
implacable	False
arreglo	False
trono	True
xv	False
obedecer	True
corbata	False
conceptual	False
tardar	False
exámen	False
fortalecer	True
seña	False
olímpico	False
muñeca	False
movilidad	True
preguntado	False
vejez	True
generado	False
desfile	True
sistemático	False
informática	True
leonor	False
anualmente	False
cotización	False
fomentar	True
desenlace	False
coyuntura	False
grabación	True
consuelo	True
lámpara	True
estatura	True
penetrar	True
examinar	True
predominio	False
atenas	False
editor	True
cajón	False
barato	False
radicalmente	False
distante	True
delincuencia	False
alejado	True
sustancial	False
relevancia	True
aviraneta	False
ordenamiento	False
nombrar	True
fabricante	True
seminario	True
inversionista	False
macho	False
consolidar	False
baloncesto	True
calificación	False
seleccionar	False
ayudante	False
preferible	False
ocio	True
char	False
plantel	False
estimular	True
suspender	True
procesamiento	True
reflexionar	True
barroco	True
envuelto	False
cortado	False
complemento	False
ingeniería	True
meramente	False
muslo	True
ascender	False
matemático	False
tendido	False
hembra	False
formalmente	False
penal	True
monseñor	False
poblado	False
vulgar	False
invención	True
jazz	True
conspiración	True
subvención	False
maleta	False
concedido	False
matanza	True
insoportable	False
pálido	True
atleta	True
generosidad	False
complutense	False
primordial	False
requerimiento	False
apropiado	False
veterano	True
asegurado	False
rodaje	False
hegemonía	False
setiembre	True
imposición	True
naturalidad	True
océano	True
inclinación	True
rechazado	False
fomento	True
faena	False
monarca	True
feroz	False
valiente	True
dialéctico	False
rastro	True
cobro	False
pulmón	True
vacuna	True
vencedor	True
portal	True
devolver	True
bombero	False
oliva	True
dueña	False
ángel	True
vencido	True
perseguir	True
orina	True
disgusto	False
terremoto	True
televisor	True
abismo	True
puño	False
patata	True
cruce	False
lealtad	True
monja	True
mejoramiento	False
aspirante	True
mediación	False
lucir	False
filial	True
bruscamente	False
sospecho	False
paja	False
fracción	False
desconocer	False
colmo	False
formulación	False
bondad	False
procurador	False
haití	True
molestia	False
extraña	True
asunción	True
asco	False
golfo	False
rencor	True
reaccionar	True
preservar	True
anillo	True
interlocutor	True
diseñado	True
patología	True
sonriente	True
anselmo	False
estrato	False
terapéutico	False
sobrino	True
guerrero	True
prestado	False
compensación	True
extendido	False
japón	True
ladrillo	False
contundente	False
enfermera	True
electorado	True
comisaría	False
susto	False
girar	True
fabricar	True
american	True
mama	False
ayudado	False
desagradable	False
cristóbal	False
clic	True
prejuicio	True
comparecencia	False
abstracción	True
consistencia	False
previsible	True
arreglar	True
camilo	False
ente	False
cia	True
belga	True
legalmente	False
oponer	False
monasterio	True
degradación	True
vestir	True
transformado	False
motivación	True
indiferente	True
cuna	True
bandeja	False
bruto	False
autora	False
anti	False
trance	True
poblador	False
porqué	False
injusto	False
sonrer	False
latín	True
inevitablemente	False
denunciado	False
incorporado	False
encerrado	True
contrabando	True
metodología	False
levantamiento	False
proso	False
eternidad	True
probado	False
indiscutible	False
sal	True
naval	False
átomo	True
articulación	True
impunidad	True
relevo	False
modesto	True
inmigración	True
euforia	True
agresividad	True
grabado	True
picada	False
muelle	False
balear	False
comparar	True
resultante	False
coca	False
azulgrana	False
ladrón	True
conquistar	False
atraer	False
devoción	True
laberinto	True
disponibilidad	False
puñado	False
che	False
extraer	False
pasaporte	True
supervisión	True
ramo	False
centavo	False
interrumpir	True
pinta	False
contienda	False
manta	False
medina	False
exclusión	True
narrador	True
recorte	False
aristótel	False
rotación	True
clemente	False
ordenación	False
instrumental	True
sucesivamente	False
procesión	True
sopa	True
corta	False
vestuario	True
cima	True
adoptado	True
admirable	False
armamento	False
chimeneo	False
descarga	False
apoyado	False
aspirar	False
telecomunicación	False
recipiente	True
orlando	True
pintado	False
total	True
conllevar	False
bolso	False
ida	False
confirmación	False
convención	True
niñez	True
goma	True
sumo	True
armario	False
sarajevo	True
continental	True
genial	False
invento	False
caridad	True
ceniza	True
soñar	True
compás	True
objetividad	True
negación	False
desequilibrio	True
originar	False
pabellón	False
inverso	False
novelista	True
comodidad	True
etarra	False
entraña	False
antepasado	True
reelección	True
alquiler	True
dividido	False
alterar	False
multa	True
verdad	False
camiseta	True
profundizar	True
siniestro	False
añadido	False
psicosis	False
uruguayo	True
razonamiento	True
roque	False
temática	False
marxismo	True
descartar	False
recomendable	False
llamamiento	False
siembra	False
mare	False
cuantía	False
remate	False
diferencial	False
vena	True
lata	False
estatuto	False
confundir	True
formular	False
aguantar	False
votante	True
replicar	False
salí	False
molde	False
autopista	False
imagino	False
derrotado	False
verter	False
jubilación	False
conversar	False
ario	False
desconcierto	False
pekín	True
prólogo	False
ratón	True
espontáneo	False
defensivo	False
cráneo	True
gravemente	False
mejoría	False
cristianismo	True
relleno	False
tinta	True
franja	False
párpado	False
gratuito	True
dividir	True
literalmente	False
nomás	False
auditorio	True
sinceridad	True
ajedrez	True
embarazado	False
físicamente	False
burlar	False
almirante	True
imaginario	False
competente	True
miserable	False
discreción	True
diferenciación	False
pianista	True
consigna	False
semejanza	False
deportista	True
matrícula	True
agonía	False
pronunciado	False
parroquia	True
extracción	True
proyectar	False
anotar	True
curación	False
manto	False
fijación	False
especulación	False
innovación	True
feo	True
provecho	False
burocracia	True
preferentemente	False
patrocinio	True
suscrito	True
sustancialmente	False
delgado	False
irme	False
expulsado	True
compartido	False
valía	False
cercanía	True
ético	False
jamón	True
segmento	False
centrar	False
operador	True
retroceso	False
pesar	False
matriz	True
caudal	True
virtual	True
gallina	False
nuboso	False
misil	False
controlado	False
suspendido	False
abstracto	False
maravilla	False
paulatinamente	False
esclavitud	True
superación	False
generoso	False
riguroso	False
biblia	True
insuficiencia	True
escudo	False
serrano	False
curar	False
reparación	True
escondido	False
intensamente	False
nieto	True
bestia	False
concretar	False
disimular	False
sodio	True
voluntariamente	False
preocupante	False
multinacional	True
freno	True
homicidio	False
hervir	False
heredero	True
indemnización	True
séptimo	False
profesorado	False
canela	False
paradoja	True
inventado	True
sencillez	False
compensar	False
excitación	True
caloría	True
estrés	True
homosexual	False
protegido	True
temía	False
afueras	False
diligencia	False
descender	True
hispano	True
celeste	True
borrar	False
quehacer	False
álbum	True
temprano	False
relacionar	False
involucrado	True
arranque	False
cómplice	False
bail	False
deseable	False
inquietante	False
legítimo	False
feto	True
industrialización	True
captación	False
acera	False
melodía	True
ordinario	False
narcotraficante	False
navegación	True
robado	False
iniciación	True
brigada	False
potable	False
precaución	True
inaugurar	False
pegar	False
gestación	True
fianza	True
toreo	False
presuntamente	False
centenario	True
dotación	False
monumental	False
ilustre	False
reparar	True
consecución	False
doctora	False
ecuación	True
mitin	False
esconder	True
detectado	False
minero	True
espíritus	True
rescatar	True
tomo	False
agotado	True
procuraduría	False
dudar	False
proporcional	True
decirtir	False
pasear	True
desigual	False
telón	False
cuaderno	True
sospechar	True
mono	False
cirujano	True
vitalidad	True
vicio	True
yema	False
utopía	True
valioso	False
mutuamente	False
dijistir	False
descubrimiento	True
desempeñar	False
reconstruir	True
tacto	True
enormemente	False
veneno	True
reconciliación	True
vertiente	False
estrechamente	False
dispersión	True
electrón	False
lámina	True
insólito	False
protocolo	True
temblor	False
cinturón	True
adaptar	True
higiene	True
palinuro	False
someter	False
helms	False
triángulo	True
criado	True
invertido	False
réplica	False
aluminio	True
américo	False
bata	False
confuso	True
enteramente	False
unánime	False
levemente	False
legado	False
aviación	True
cruzado	False
compasión	True
cortesía	True
trapo	False
convencimiento	False
rallado	False
coma	False
recesión	True
compatriota	False
cuadra	False
violín	True
alcoholismo	True
camarero	False
textura	True
quedo	False
reclamo	True
silueta	False
ecológico	False
explotar	False
nacho	False
asumido	False
bastón	False
especialización	False
racionalidad	True
metálico	True
frontal	False
rata	False
depresivo	False
crueldad	False
retención	False
despertado	False
renacimiento	True
soberbia	False
valle	True
auxilio	True
convergencia	False
saliva	True
facción	True
proliferación	False
nómina	False
olla	False
secuestrado	False
liquidación	False
lienzo	False
idiota	False
hormona	True
manga	False
apreciación	True
largamente	False
semanario	True
flexible	True
desacuerdo	True
atreverse	False
serpiente	True
correlación	True
prosperidad	True
escape	False
fotográfico	False
discreto	False
ministerial	False
cereal	True
crucial	True
pascual	False
sendero	True
canadiense	True
nudo	False
emisor	True
erosión	True
obligatorio	False
encabezar	False
cineasta	True
lavar	False
cauce	True
flamenco	True
rebaja	True
polo	False
descontento	True
economista	True
tope	False
simpático	False
indirectamente	False
demora	False
despejado	False
cueva	True
oyente	False
encerrar	False
hidrógeno	True
quieto	False
velada	False
amargo	True
dinámico	False
encender	True
administrar	False
soltar	False
geometría	True
recuento	False
tropical	True
mostrador	False
progresista	False
gradual	True
aurora	True
cuñado	False
prostitución	False
liberalización	True
tumor	True
jacinto	False
custodia	True
brisa	True
protestar	True
cohesión	False
extremidad	False
mate	False
fósil	True
cerco	False
cargar	False
insulto	True
decepción	False
tibia	False
cesar	False
proseguir	False
mayoritario	True
liberar	True
encendido	False
rendir	False
precioso	True
nativo	True
discrepancia	False
viabilidad	False
socialmente	False
sugerencia	True
contratar	False
lineal	True
vísperas	False
explosivo	True
agradecimiento	True
ventanilla	False
movido	False
formidable	False
descendiente	True
renovar	False
helado	False
dionisio	True
toma	True
escogido	False
vayas	False
bando	False
vener	False
espuma	True
vocal	False
gigantesco	False
batería	True
contribuyente	True
abastecimiento	False
aguja	False
codo	True
afortunadamente	False
inserción	False
talante	False
torpe	True
precipitación	False
recibo	True
rodar	False
interpretado	False
autorizado	False
dioso	False
incómodo	False
lucrecia	False
mudo	True
fracasado	True
suavidad	True
fugaz	True
activamente	False
regir	False
vitoria	False
despido	False
prescindir	False
francamente	False
dominación	True
implicación	False
designar	False
mozo	False
amoro	False
rentable	False
resaltar	False
calibre	True
originalidad	False
históricamente	False
vestíbulo	True
cocer	False
lucidez	False
fina	False
ezequiel	False
pipa	False
ceja	True
guapo	True
rebeldía	False
protector	True
opositor	True
cubrar	False
interrogante	False
tirado	False
restar	False
reproducir	False
envergadura	True
agitación	True
amarguro	False
devolución	True
vértigo	False
murmurar	True
alzar	False
disminuido	False
certificar	True
lío	False
estallido	False
extra	False
enfermería	True
asomar	False
prolongación	False
liberado	True
excursión	False
membrana	True
concentrado	False
cal	False
capricho	True
aconsejable	False
ascensor	True
cátedra	False
dinamismo	False
honestidad	True
verificar	True
contemplación	True
falsedad	True
sereno	False
acumulado	False
conformación	False
cautela	False
descomposición	True
lomo	False
viceversa	False
chorro	False
callado	False
camioneta	False
concha	True
agresivo	False
inventar	True
vocero	False
genero	False
auxiliar	False
biología	True
abanico	False
electo	False
polémico	True
carcajada	False
nutrición	True
despedir	False
opresión	False
comportar	False
defendido	False
cantabria	True
sincero	True
inmediaciones	False
velo	False
difunto	False
reinado	False
milla	True
oficio	True
encierro	False
incumplimiento	True
linda	False
nutriente	False
eguren	False
mixto	False
paradigma	False
realizador	False
consorcio	True
saludable	True
puntualizar	False
refuerzo	False
diversión	True
fortalecimiento	True
mezclar	False
jaula	True
silencioso	False
contratado	True
arrastrar	False
tele	False
saludar	True
incipiente	False
franquista	False
cañón	True
dominado	False
patricio	False
pastor	True
sequía	True
difundir	False
contraloría	False
show	True
metabolismo	True
etiqueta	False
extraordinariamente	False
concebir	True
ambigüedad	True
campana	True
soberano	True
súbito	False
bulto	False
kid	False
promotor	True
brindar	False
atributo	True
fray	False
irreversible	True
arterial	True
petrolero	False
diverso	False
contracción	False
rigidez	True
itinerario	True
cónsul	True
sartén	False
alfombra	True
tribu	False
adjunto	False
banquero	False
licitación	True
desigualdad	True
aliviar	True
indudablemente	False
guante	True
adjudicación	False
larra	False
compadre	True
